6,12,-6,1,0.7066112104915813,0
9,18,-9,1,0.8957642993112265,0
10,20,-10,1,0.18604180105476043,0
16,32,-16,1,0.48617810294921326,0
18,36,-18,1,0.12872477900561674,0
23,46,-23,1,0.6043946408689774,0
26,52,-26,1,0.9588355818457629,0
27,54,-27,1,0.5128320360888492,0
32,64,-32,1,0.0441454094687066,0
33,66,-33,1,0.9458425112911718,0
34,68,-34,1,0.4879405580227586,0
37,74,-37,1,0.5964557904211127,0
39,78,-39,1,0.23472412029575507,0
41,82,-41,1,0.9878130436112407,0
43,86,-43,1,0.7617588561965701,0
44,88,-44,1,0.897784080704955,0
45,90,-45,1,0.7417154834475754,0
47,94,-47,1,0.3242564607058931,0
53,106,-53,1,0.6548658596160829,0
54,108,-54,1,0.13195961188140082,0
55,110,-55,1,0.4579305012806876,0
56,112,-56,1,0.35248489331377875,0
64,128,-64,1,0.9509142460984752,0
71,142,-71,1,0.27560301413022015,0
73,146,-73,1,0.9696116226706298,0
75,150,-75,1,0.5484382566060816,0
76,152,-76,1,0.8159152050577259,0
81,162,-81,1,0.3392369018503475,0
82,164,-82,1,0.6730597690597684,0
84,168,-84,1,0.11882419798213051,0
85,170,-85,1,0.723059382704644,0
89,178,-89,1,0.8048845390654428,0
90,180,-90,1,0.2556182886055399,0
91,182,-91,1,0.6238460549567523,0
92,184,-92,1,0.832153872922959,0
102,204,-102,1,0.41206514251566695,0
105,210,-105,1,0.8982815218876549,0
109,218,-109,1,0.3377373298940526,0
110,220,-110,1,0.5206384625210277,0
112,224,-112,1,0.4232405557656941,0
116,232,-116,1,0.8037524128209419,0
117,234,-117,1,0.6983299486299003,0
118,236,-118,1,0.7057576646011063,0
120,240,-120,1,0.1076044143749657,0
121,242,-121,1,0.3920223552516685,0
122,244,-122,1,0.23064692131169773,0
123,246,-123,1,0.015179315501767099,0
124,248,-124,1,0.9846210186336095,0
128,256,-128,1,0.9121136519032607,0
134,268,-134,1,0.8225795573332777,0
136,272,-136,1,0.6948127821950324,0
137,274,-137,1,0.5213043689425857,0
138,276,-138,1,0.350883750597237,0
140,280,-140,1,0.7231115660491775,0
145,290,-145,1,0.8506354722051263,0
150,300,-150,1,0.3683495210059353,0
151,302,-151,1,0.016357533825861914,0
153,306,-153,1,0.3836447231406731,0
158,316,-158,1,0.010009581331857809,0
163,326,-163,1,0.501019590779959,0
166,332,-166,1,0.6843604951736049,0
168,336,-168,1,0.19108876890855409,0
176,352,-176,1,0.33428169936780416,0
181,362,-181,1,0.4354316040486125,0
186,372,-186,1,0.8219002588188558,0
188,376,-188,1,0.678669140005955,0
193,386,-193,1,0.6446534712222717,0
194,388,-194,1,0.8703753328814268,0
195,390,-195,1,0.2654400377659598,0
202,404,-202,1,0.46616954770824803,0
206,412,-206,1,0.2685075066483277,0
207,414,-207,1,0.6471496252293015,0
212,424,-212,1,0.7406136232824378,0
214,428,-214,1,0.4653681600446983,0
215,430,-215,1,0.15064353429203448,0
219,438,-219,1,0.8044306260342153,0
222,444,-222,1,0.9308613994265799,0
230,460,-230,1,0.7197135771654014,0
232,464,-232,1,0.5154323759229834,0
234,468,-234,1,0.6627623132633486,0
236,472,-236,1,0.057927226045518476,0
237,474,-237,1,0.11861834137227922,0
239,478,-239,1,0.43305143830534376,0
242,484,-242,1,0.9866565565279789,0
249,498,-249,1,0.07862219782415913,0
251,502,-251,1,0.22277151591183597,0
253,506,-253,1,0.9274795723707209,0
254,508,-254,1,0.4924839322282166,0
257,514,-257,1,0.17509952641813398,0
258,516,-258,1,0.19464284644310492,0
261,522,-261,1,0.890318170218856,0
273,546,-273,1,0.12629097834902114,0
274,548,-274,1,0.03591310910966139,0
275,550,-275,1,0.2555793736490861,0
280,560,-280,1,0.02679276868375069,0
285,570,-285,1,0.8996583025266899,0
292,584,-292,1,0.07098140036055056,0
295,590,-295,1,0.8886720177724742,0
299,598,-299,1,0.3953886775750145,0
300,600,-300,1,0.250694527995619,0
306,612,-306,1,0.20548595491154198,0
315,630,-315,1,0.8154540637240346,0
316,632,-316,1,0.22525522268363984,0
317,634,-317,1,0.8943917709230218,0
322,644,-322,1,0.3363686852677654,0
323,646,-323,1,0.5549377391555338,0
326,652,-326,1,0.6472155746390797,0
331,662,-331,1,0.4838823137747972,0
333,666,-333,1,0.34955082347668887,0
334,668,-334,1,0.03721527591379259,0
335,670,-335,1,0.4328997186680229,0
338,676,-338,1,0.8888956438136358,0
339,678,-339,1,0.6147445502843156,0
343,686,-343,1,0.06166647621225407,0
345,690,-345,1,0.8148771933106321,0
346,692,-346,1,0.6467992080188075,0
348,696,-348,1,0.37567215660805076,0
350,700,-350,1,0.6653121232504471,0
352,704,-352,1,0.5523947022614649,0
353,706,-353,1,0.8301469977189273,0
355,710,-355,1,0.38968240008921184,0
357,714,-357,1,0.4042773659140636,0
360,720,-360,1,0.737021925392959,0
365,730,-365,1,0.5533731766813362,0
366,732,-366,1,0.09120895524841077,0
372,744,-372,1,0.5152099928869572,0
373,746,-373,1,0.04827003697816645,0
378,756,-378,1,0.10655635658732854,0
381,762,-381,1,0.8194476858740763,0
383,766,-383,1,0.7344875246513959,0
388,776,-388,1,0.25867095977888654,0
390,780,-390,1,0.05867113970850768,0
394,788,-394,1,0.609345418302784,0
397,794,-397,1,0.9490692816970399,0
407,814,-407,1,0.8357275687847188,0
408,816,-408,1,0.3678507562172806,0
417,834,-417,1,0.8643761416893766,0
418,836,-418,1,0.502672762947131,0
419,838,-419,1,0.6600221664160331,0
420,840,-420,1,0.7880861017908498,0
421,842,-421,1,0.446357320579158,0
422,844,-422,1,0.45632671433249683,0
423,846,-423,1,0.6251304728860806,0
427,854,-427,1,0.3355888502914358,0
428,856,-428,1,0.43120272550598693,0
429,858,-429,1,0.5482608867674174,0
432,864,-432,1,0.17046842076058422,0
434,868,-434,1,0.6440705259854101,0
441,882,-441,1,0.6194347420863874,0
444,888,-444,1,0.7822096205590463,0
445,890,-445,1,0.6468333461645749,0
447,894,-447,1,0.6245084113828987,0
450,900,-450,1,0.02611449987919845,0
452,904,-452,1,0.8062704938792677,0
456,912,-456,1,0.6007301609756257,0
457,914,-457,1,0.9154864914970573,0
461,922,-461,1,0.3906829546970234,0
462,924,-462,1,0.9237756063132632,0
463,926,-463,1,0.46214021561091023,0
464,928,-464,1,0.885043580719426,0
468,936,-468,1,0.26985189677699184,0
469,938,-469,1,0.44842830666756306,0
472,944,-472,1,0.3953162706872223,0
473,946,-473,1,0.7193585646335667,0
474,948,-474,1,0.2933374927153698,0
475,950,-475,1,0.8660644430638247,0
479,958,-479,1,0.22425904585560064,0
480,960,-480,1,0.2480812623558124,0
484,968,-484,1,0.3299969816650231,0
485,970,-485,1,0.42125292691002336,0
494,988,-494,1,0.704128844281997,0
495,990,-495,1,0.8219513309985188,0
496,992,-496,1,0.044008856656978734,0
502,1004,-502,1,0.7518792848654854,0
505,1010,-505,1,0.18925403059733337,0
506,1012,-506,1,0.026056024153869428,0
510,1020,-510,1,0.3032605986480513,0
512,1024,-512,1,0.56855395695581,0
514,1028,-514,1,0.2789618838414536,0
515,1030,-515,1,0.053794130877520274,0
516,1032,-516,1,0.7441094479366962,0
517,1034,-517,1,0.3857987013648848,0
522,1044,-522,1,0.16616612090419403,0
524,1048,-524,1,0.35662129980488344,0
526,1052,-526,1,0.7779953195733844,0
529,1058,-529,1,0.5767331709947595,0
530,1060,-530,1,0.5009945542323084,0
531,1062,-531,1,0.08100575756046169,0
532,1064,-532,1,0.23578659094319832,0
533,1066,-533,1,0.6466625357792539,0
534,1068,-534,1,0.4653952146763001,0
540,1080,-540,1,0.0880192275504873,0
545,1090,-545,1,0.8585418733640074,0
546,1092,-546,1,0.6703953038298294,0
547,1094,-547,1,0.11739718996308102,0
549,1098,-549,1,0.6515465713568024,0
553,1106,-553,1,0.685193741134465,0
555,1110,-555,1,0.7685013834860214,0
564,1128,-564,1,0.9176493391108961,0
565,1130,-565,1,0.4657868839092063,0
569,1138,-569,1,0.8332332987181627,0
570,1140,-570,1,0.8899191421578003,0
578,1156,-578,1,0.6241824633718748,0
580,1160,-580,1,0.2816258045641331,0
586,1172,-586,1,0.4931453073921741,0
594,1188,-594,1,0.3875166886008693,0
595,1190,-595,1,0.12080927926619667,0
600,1200,-600,1,0.696460538467996,0
604,1208,-604,1,0.38562815990771027,0
609,1218,-609,1,0.5194590997804192,0
613,1226,-613,1,0.042584496901176494,0
614,1228,-614,1,0.40974199603532246,0
616,1232,-616,1,0.9319168294824401,0
622,1244,-622,1,0.8126558789470227,0
623,1246,-623,1,0.6347637611607448,0
625,1250,-625,1,0.1686772381552777,0
626,1252,-626,1,0.37693334891648966,0
627,1254,-627,1,0.3493924676464818,0
632,1264,-632,1,0.2172905131232249,0
638,1276,-638,1,0.5001025652979622,0
639,1278,-639,1,0.9689959228783726,0
641,1282,-641,1,0.89153195964182,0
645,1290,-645,1,0.06045492754493187,0
646,1292,-646,1,0.5680549558582395,0
650,1300,-650,1,0.9473095363063908,0
651,1302,-651,1,0.06563675590596729,0
655,1310,-655,1,0.11087936512507246,0
656,1312,-656,1,0.15783325542043714,0
659,1318,-659,1,0.6005606072558028,0
664,1328,-664,1,0.9593134407433555,0
666,1332,-666,1,0.19415802978092267,0
668,1336,-668,1,0.7926718538136069,0
671,1342,-671,1,0.5594502787334797,0
673,1346,-673,1,0.985678330602285,0
677,1354,-677,1,0.9815068441965931,0
678,1356,-678,1,0.37665692869220757,0
679,1358,-679,1,0.7388909574057908,0
686,1372,-686,1,0.30918114340781866,0
687,1374,-687,1,0.6416911393750522,0
688,1376,-688,1,0.04165784392103833,0
692,1384,-692,1,0.7161481133818357,0
693,1386,-693,1,0.6839020237633654,0
694,1388,-694,1,0.6200615464327905,0
697,1394,-697,1,0.17102982517494247,0
698,1396,-698,1,0.47337128540249385,0
702,1404,-702,1,0.2927273529703097,0
704,1408,-704,1,0.9785116759066916,0
712,1424,-712,1,0.19939122293156275,0
713,1426,-713,1,0.11226555646983649,0
719,1438,-719,1,0.18789598008768538,0
720,1440,-720,1,0.5150951732090469,0
721,1442,-721,1,0.9769994669426808,0
722,1444,-722,1,0.864252397846666,0
728,1456,-728,1,0.05651817682620419,0
730,1460,-730,1,0.7736234914254712,0
733,1466,-733,1,0.8002060111736998,0
735,1470,-735,1,0.7403939982761601,0
738,1476,-738,1,0.5251667656739846,0
740,1480,-740,1,0.5629524598615984,0
743,1486,-743,1,0.9858131823950107,0
749,1498,-749,1,0.6327449435851088,0
750,1500,-750,1,0.33905702400321525,0
752,1504,-752,1,0.10905547012750705,0
753,1506,-753,1,0.2676424206733845,0
758,1516,-758,1,0.19118913555363437,0
759,1518,-759,1,0.16507506437730024,0
761,1522,-761,1,0.06199683281079449,0
763,1526,-763,1,0.2519267347955102,0
764,1528,-764,1,0.9880561073187829,0
768,1536,-768,1,0.9384531666456615,0
772,1544,-772,1,0.633595579676261,0
780,1560,-780,1,0.99116853921091,0
781,1562,-781,1,0.9668141954409322,0
792,1584,-792,1,0.3204904883776085,0
806,1612,-806,1,0.9468372907947363,0
807,1614,-807,1,0.40672231918021784,0
810,1620,-810,1,0.5766069388808684,0
812,1624,-812,1,0.5942982795448809,0
817,1634,-817,1,0.8044087049523398,0
820,1640,-820,1,0.19454400199174737,0
821,1642,-821,1,0.25746878890996383,0
823,1646,-823,1,0.37064846271239915,0
825,1650,-825,1,0.5101156142906674,0
826,1652,-826,1,0.8211813921134467,0
827,1654,-827,1,0.895871303687808,0
828,1656,-828,1,0.15933957162097911,0
831,1662,-831,1,0.3006691027248748,0
833,1666,-833,1,0.7647107537535838,0
836,1672,-836,1,0.9140236303286072,0
837,1674,-837,1,0.9457488572706413,0
838,1676,-838,1,0.2502805192449098,0
839,1678,-839,1,0.942415091483056,0
840,1680,-840,1,0.5499371623540991,0
848,1696,-848,1,0.01685537303296125,0
849,1698,-849,1,0.3308110175465987,0
850,1700,-850,1,0.9672862667236682,0
852,1704,-852,1,0.03639985947101354,0
853,1706,-853,1,0.9458751116555767,0
854,1708,-854,1,0.7874644558326025,0
858,1716,-858,1,0.6368388806352671,0
861,1722,-861,1,0.8373632919376734,0
863,1726,-863,1,0.08629014767559118,0
865,1730,-865,1,0.17307129133077714,0
878,1756,-878,1,0.2844141605604924,0
880,1760,-880,1,0.8607166524457057,0
881,1762,-881,1,0.06537171441263612,0
882,1764,-882,1,0.28847495002615275,0
884,1768,-884,1,0.2997110796333683,0
887,1774,-887,1,0.07572849061945719,0
897,1794,-897,1,0.7911484490685933,0
899,1798,-899,1,0.9216228433899556,0
904,1808,-904,1,0.8713743074193402,0
905,1810,-905,1,0.720426332494516,0
906,1812,-906,1,0.6431804108754964,0
908,1816,-908,1,0.718482773982739,0
912,1824,-912,1,0.33964528946902584,0
915,1830,-915,1,0.7877176089108423,0
918,1836,-918,1,0.09436489669845094,0
919,1838,-919,1,0.8928926689585427,0
921,1842,-921,1,0.6242991088342746,0
924,1848,-924,1,0.33759799298507653,0
929,1858,-929,1,0.29652165621364224,0
933,1866,-933,1,0.4958626723245074,0
934,1868,-934,1,0.3243231331990185,0
935,1870,-935,1,0.29709670329471916,0
937,1874,-937,1,0.24211406164389437,0
939,1878,-939,1,0.8322889456255401,0
947,1894,-947,1,0.2507186563146194,0
948,1896,-948,1,0.15739642229523176,0
949,1898,-949,1,0.2895948983763018,0
951,1902,-951,1,0.18394171094831657,0
953,1906,-953,1,0.511019552319653,0
954,1908,-954,1,0.4423274630682844,0
955,1910,-955,1,0.5151945540227937,0
960,1920,-960,1,0.986645479359628,0
965,1930,-965,1,0.3708307170898757,0
967,1934,-967,1,0.08053895612071171,0
973,1946,-973,1,0.7151827777054628,0
974,1948,-974,1,0.25597370322082025,0
975,1950,-975,1,0.40516063101793376,0
976,1952,-976,1,0.3148805684346184,0
982,1964,-982,1,0.04198978735188119,0
990,1980,-990,1,0.1779313878981691,0
991,1982,-991,1,0.48564509602706296,0
994,1988,-994,1,0.4308197028478852,0
997,1994,-997,1,0.9088914438517282,0
998,1996,-998,1,0.5460704672148825,0
999,1998,-999,1,0.2514769037087783,0
1000,2000,-1000,1,0.7734749459200979,0
1005,2010,-1005,1,0.0397745659951525,0
1014,2028,-1014,1,0.8128759141656163,0
1015,2030,-1015,1,0.6404977441515755,0
1017,2034,-1017,1,0.4442831168625271,0
1019,2038,-1019,1,0.22115880793234455,0
1022,2044,-1022,1,0.3230214963370115,0
1029,2058,-1029,1,0.3639183369252814,0
1034,2068,-1034,1,0.8732772073909612,0
1035,2070,-1035,1,0.5837269891234442,0
1037,2074,-1037,1,0.832814942887611,0
1039,2078,-1039,1,0.8814683313351357,0
1055,2110,-1055,1,0.09145745167266173,0
1058,2116,-1058,1,0.47590272794174315,0
1063,2126,-1063,1,0.8598288329222538,0
1064,2128,-1064,1,0.6172447982305052,0
1072,2144,-1072,1,0.533959775786716,0
1073,2146,-1073,1,0.6092233254052196,0
1078,2156,-1078,1,0.20859990123519245,0
1082,2164,-1082,1,0.07361347693390385,0
1086,2172,-1086,1,0.5314426326557858,0
1091,2182,-1091,1,0.7916732252999185,0
1093,2186,-1093,1,0.5819747864733137,0
1096,2192,-1096,1,0.8492007120784051,0
1101,2202,-1101,1,0.7259645452950847,0
1103,2206,-1103,1,0.17608682893093042,0
1104,2208,-1104,1,0.1339070745633174,0
1115,2230,-1115,1,0.4679747817537364,0
1123,2246,-1123,1,0.24937237214554442,0
1125,2250,-1125,1,0.40866012703325505,0
1128,2256,-1128,1,0.210668259745725,0
1130,2260,-1130,1,0.8495601575287842,0
1131,2262,-1131,1,0.5610609946779257,0
1133,2266,-1133,1,0.6432564926995582,0
1135,2270,-1135,1,0.3771919114010065,0
1136,2272,-1136,1,0.46219809488775876,0
1138,2276,-1138,1,0.025234324327257807,0
1142,2284,-1142,1,0.31322340333666177,0
1143,2286,-1143,1,0.5146421144144607,0
1148,2296,-1148,1,0.5717758895638678,0
1149,2298,-1149,1,0.8724711113966669,0
1152,2304,-1152,1,0.03209463018317682,0
1153,2306,-1153,1,0.8578499682300682,0
1154,2308,-1154,1,0.2266595634671783,0
1161,2322,-1161,1,0.5462700894425905,0
1162,2324,-1162,1,0.04527541077960018,0
1166,2332,-1166,1,0.4673893300980996,0
1169,2338,-1169,1,0.21848193507791758,0
1170,2340,-1170,1,0.40384442219301353,0
1175,2350,-1175,1,0.3948673423252985,0
1178,2356,-1178,1,0.19204546770990139,0
1179,2358,-1179,1,0.6802520891206806,0
1183,2366,-1183,1,0.6945130332572828,0
1185,2370,-1185,1,0.8367781577312324,0
1187,2374,-1187,1,0.02816357762252797,0
1188,2376,-1188,1,0.04548163803369176,0
1192,2384,-1192,1,0.8368662920339524,0
1200,2400,-1200,1,0.15062935559326407,0
1202,2404,-1202,1,0.29881065612041224,0
1203,2406,-1203,1,0.008697025594292529,0
1205,2410,-1205,1,0.8912544418580332,0
1210,2420,-1210,1,0.10420921825612572,0
1211,2422,-1211,1,0.8424995607406188,0
1212,2424,-1212,1,0.3043842255397363,0
1213,2426,-1213,1,0.18676342021241243,0
1215,2430,-1215,1,0.4729079437455045,0
1216,2432,-1216,1,0.33093987205256226,0
1220,2440,-1220,1,0.45414976071512114,0
1222,2444,-1222,1,0.981563996400367,0
1225,2450,-1225,1,0.12970350165140132,0
1226,2452,-1226,1,0.011728388013426017,0
1230,2460,-1230,1,0.07781545804719203,0
1234,2468,-1234,1,0.48757926026091036,0
1235,2470,-1235,1,0.215990477560141,0
1237,2474,-1237,1,0.03349219852375285,0
1240,2480,-1240,1,0.9634090205590232,0
1251,2502,-1251,1,0.058251294669882325,0
1253,2506,-1253,1,0.1516075667637493,0
1257,2514,-1257,1,0.07245010341968416,0
1259,2518,-1259,1,0.7951689556258964,0
1262,2524,-1262,1,0.4301924921349888,0
1263,2526,-1263,1,0.3547191570103154,0
1266,2532,-1266,1,0.7528805379691691,0
1284,2568,-1284,1,0.6130642209337732,0
1294,2588,-1294,1,0.5867512058838558,0
1296,2592,-1296,1,0.5420778770147553,0
1297,2594,-1297,1,0.12785912402496846,0
1298,2596,-1298,1,0.26488794544983785,0
1299,2598,-1299,1,0.986502479211062,0
1308,2616,-1308,1,0.8080633881123065,0
1312,2624,-1312,1,0.5044782671237371,0
1315,2630,-1315,1,0.4839418402133876,0
1325,2650,-1325,1,0.3506574871900452,0
1328,2656,-1328,1,0.7752922068185291,0
1329,2658,-1329,1,0.3644645010349772,0
1336,2672,-1336,1,0.9733969843468534,0
1337,2674,-1337,1,0.47631869801222215,0
1339,2678,-1339,1,0.13335876991727613,0
1340,2680,-1340,1,0.014524176923836118,0
1342,2684,-1342,1,0.7261107159983203,0
1343,2686,-1343,1,0.8327142237110209,0
1344,2688,-1344,1,0.8310287642024471,0
1351,2702,-1351,1,0.8520211623396438,0
1354,2708,-1354,1,0.47011728912199735,0
1356,2712,-1356,1,0.7357455813134511,0
1357,2714,-1357,1,0.3543820356985832,0
1365,2730,-1365,1,0.8362007656771028,0
1367,2734,-1367,1,0.40808363324377517,0
1368,2736,-1368,1,0.5389002669077627,0
1369,2738,-1369,1,0.4741358093976168,0
1372,2744,-1372,1,0.4704293162014591,0
1377,2754,-1377,1,0.03901010065739641,0
1379,2758,-1379,1,0.6741701617588024,0
1388,2776,-1388,1,0.14449915109379774,0
1391,2782,-1391,1,0.3770558264459851,0
1392,2784,-1392,1,0.6859656447222614,0
1394,2788,-1394,1,0.14554356092994059,0
1395,2790,-1395,1,0.28136437036084117,0
1397,2794,-1397,1,0.7678655286918997,0
1398,2796,-1398,1,0.3583643522334786,0
1401,2802,-1401,1,0.9028704303488408,0
1402,2804,-1402,1,0.4541257250885359,0
1403,2806,-1403,1,0.9995686555065667,0
1407,2814,-1407,1,0.9391151005830145,0
1410,2820,-1410,1,0.7210532683207991,0
1416,2832,-1416,1,0.619812442574463,0
1419,2838,-1419,1,0.21377012749068836,0
1420,2840,-1420,1,0.06241848499247393,0
1421,2842,-1421,1,0.25167348444584436,0
1425,2850,-1425,1,0.12854858245764333,0
1426,2852,-1426,1,0.43514661622210615,0
1436,2872,-1436,1,0.6120296568452422,0
1443,2886,-1443,1,0.6524524891498458,0
1444,2888,-1444,1,0.6979004657418808,0
1447,2894,-1447,1,0.5067799348726232,0
1449,2898,-1449,1,0.3038560153764307,0
1458,2916,-1458,1,0.6719414205101089,0
1460,2920,-1460,1,0.20750881310888247,0
1464,2928,-1464,1,0.8119428261613885,0
1470,2940,-1470,1,0.7695065068317146,0
1471,2942,-1471,1,0.912171065532021,0
1472,2944,-1472,1,0.8228289537361047,0
1479,2958,-1479,1,0.948860873781649,0
1487,2974,-1487,1,0.33644640923861124,0
1489,2978,-1489,1,0.6535954390828678,0
1490,2980,-1490,1,0.28601005205059105,0
1491,2982,-1491,1,0.06621702051521527,0
1497,2994,-1497,1,0.7615636704727297,0
1498,2996,-1498,1,0.6206303192334536,0
1499,2998,-1499,1,0.3943886161792093,0
1500,3000,-1500,1,0.5889625536684739,0
1502,3004,-1502,1,0.27426149550812207,0
1504,3008,-1504,1,0.2989086143147114,0
1508,3016,-1508,1,0.6407218845359849,0
1509,3018,-1509,1,0.9495314759414756,0
1511,3022,-1511,1,0.3393137821670883,0
1515,3030,-1515,1,0.7293849707011788,0
1516,3032,-1516,1,0.16268718625310752,0
1520,3040,-1520,1,0.01225531249855849,0
1522,3044,-1522,1,0.42318333621964876,0
1523,3046,-1523,1,0.98338921483948,0
1524,3048,-1524,1,0.4673751250125897,0
1526,3052,-1526,1,0.09732897463062673,0
1528,3056,-1528,1,0.5209768383785739,0
1530,3060,-1530,1,0.1937595605149527,0
1532,3064,-1532,1,0.35104700205396977,0
1533,3066,-1533,1,0.287028104112215,0
1536,3072,-1536,1,0.5744416782286971,0
1538,3076,-1538,1,0.2094296170529173,0
1544,3088,-1544,1,0.12478398326827278,0
1550,3100,-1550,1,0.566214626680113,0
1551,3102,-1551,1,0.47440050981660564,0
1552,3104,-1552,1,0.7030202899063447,0
1556,3112,-1556,1,0.6078150649125609,0
1558,3116,-1558,1,0.19773258563215468,0
1559,3118,-1559,1,0.3352691331511075,0
1560,3120,-1560,1,0.6171591502063534,0
1561,3122,-1561,1,0.7550594400244345,0
1562,3124,-1562,1,0.44859722064145524,0
1563,3126,-1563,1,0.8532467182104917,0
1564,3128,-1564,1,0.2967119476100495,0
1567,3134,-1567,1,0.30693092723780524,0
1577,3154,-1577,1,0.020986431466509914,0
1578,3156,-1578,1,0.6068481679649136,0
1580,3160,-1580,1,0.8807807419128177,0
1581,3162,-1581,1,0.19831514870647982,0
1583,3166,-1583,1,0.33055636057601834,0
1585,3170,-1585,1,0.9797773402136942,0
1586,3172,-1586,1,0.023405354164824477,0
1588,3176,-1588,1,0.9847367602980456,0
1590,3180,-1590,1,0.8618401220877597,0
1594,3188,-1594,1,0.0829468167941465,0
1597,3194,-1597,1,0.7713107075604901,0
1605,3210,-1605,1,0.9694021023086493,0
1606,3212,-1606,1,4.410027129087002e-05,0
1607,3214,-1607,1,0.5404190812505101,0
1612,3224,-1612,1,0.16917430357113072,0
1613,3226,-1613,1,0.4406362002248191,0
1614,3228,-1614,1,0.5962265956393726,0
1619,3238,-1619,1,0.9787190003413389,0
1621,3242,-1621,1,0.41154913071211263,0
1624,3248,-1624,1,0.12328550044250786,0
1629,3258,-1629,1,0.8984028278919296,0
1633,3266,-1633,1,0.23477076063108193,0
1635,3270,-1635,1,0.6786693525666556,0
1636,3272,-1636,1,0.11330428130666137,0
1638,3276,-1638,1,0.16553391169209486,0
1641,3282,-1641,1,0.09157748648826325,0
1643,3286,-1643,1,0.9714989651736686,0
1646,3292,-1646,1,0.4610155232682682,0
1649,3298,-1649,1,0.6135219007327241,0
1656,3312,-1656,1,0.43592703004428446,0
1658,3316,-1658,1,0.3103265443861064,0
1659,3318,-1659,1,0.2976380403520298,0
1660,3320,-1660,1,0.019468165290328576,0
1661,3322,-1661,1,0.6557665386990986,0
1662,3324,-1662,1,0.4961195358529086,0
1672,3344,-1672,1,0.1295755301292032,0
1673,3346,-1673,1,0.36135760738238154,0
1681,3362,-1681,1,0.28605192766878884,0
1683,3366,-1683,1,0.6767019095634917,0
1684,3368,-1684,1,0.6389383624754329,0
1686,3372,-1686,1,0.9401114627756287,0
1687,3374,-1687,1,0.566360985824667,0
1691,3382,-1691,1,0.276850462296207,0
1694,3388,-1694,1,0.8102895475348166,0
1696,3392,-1696,1,0.5097475924713708,0
1697,3394,-1697,1,0.31865149520586566,0
1704,3408,-1704,1,0.881399439029141,0
1709,3418,-1709,1,0.5586732808257799,0
1712,3424,-1712,1,0.4745101478695398,0
1716,3432,-1716,1,0.7331135359206447,0
1717,3434,-1717,1,0.34759427433213874,0
1718,3436,-1718,1,0.5031367906942171,0
1719,3438,-1719,1,0.47463099658966246,0
1730,3460,-1730,1,0.2785318966303554,0
1731,3462,-1731,1,0.9888340943829823,0
1732,3464,-1732,1,0.6288342267611502,0
1738,3476,-1738,1,0.6605513192608415,0
1739,3478,-1739,1,0.15653639429919397,0
1748,3496,-1748,1,0.5800551240421241,0
1760,3520,-1760,1,0.4413516834730431,0
1761,3522,-1761,1,0.12662329568652775,0
1766,3532,-1766,1,0.2446992054494047,0
1773,3546,-1773,1,0.30945746517702977,0
1774,3548,-1774,1,0.31092744734451305,0
1776,3552,-1776,1,0.5515200996898637,0
1778,3556,-1778,1,0.145538830661063,0
1783,3566,-1783,1,0.33863655889238675,0
1785,3570,-1785,1,0.8972427029725218,0
1786,3572,-1786,1,0.8306761451104081,0
1790,3580,-1790,1,0.9898615804121402,0
1791,3582,-1791,1,0.8408636311720482,0
1792,3584,-1792,1,0.060955351057453644,0
1793,3586,-1793,1,0.11019011284141689,0
1796,3592,-1796,1,0.1887876083414839,0
1797,3594,-1797,1,0.29871421577320956,0
1804,3608,-1804,1,0.3785485358600743,0
1808,3616,-1808,1,0.37445207279099035,0
1809,3618,-1809,1,0.42017965552013503,0
1813,3626,-1813,1,0.3416047367668096,0
1816,3632,-1816,1,0.45254036371008044,0
1819,3638,-1819,1,0.0022074515848096166,0
1821,3642,-1821,1,0.7338361744205789,0
1823,3646,-1823,1,0.4089207841176826,0
1829,3658,-1829,1,0.7995201711838876,0
1834,3668,-1834,1,0.7191645835195076,0
1838,3676,-1838,1,0.1933717036139444,0
1843,3686,-1843,1,0.7251252741692192,0
1844,3688,-1844,1,0.08113828744028828,0
1848,3696,-1848,1,0.14833086884427593,0
1849,3698,-1849,1,0.6216279596547382,0
1850,3700,-1850,1,0.7090857894422905,0
1851,3702,-1851,1,0.42006792892918765,0
1852,3704,-1852,1,0.7451431304109994,0
1853,3706,-1853,1,0.2560686078698384,0
1854,3708,-1854,1,0.4665446918171703,0
1856,3712,-1856,1,0.8382753284745859,0
1859,3718,-1859,1,0.39126015124903213,0
1860,3720,-1860,1,0.6043466434018487,0
1861,3722,-1861,1,0.42693151145096053,0
1863,3726,-1863,1,0.33664591147755885,0
1867,3734,-1867,1,0.735360221625172,0
1868,3736,-1868,1,0.11463371446270187,0
1869,3738,-1869,1,0.4244396140176998,0
1871,3742,-1871,1,0.7655248559950494,0
1873,3746,-1873,1,0.5158640617857899,0
1874,3748,-1874,1,0.29589857473076464,0
1875,3750,-1875,1,0.675728743804458,0
1877,3754,-1877,1,0.5790327753179803,0
1889,3778,-1889,1,0.7624883559507758,0
1890,3780,-1890,1,0.4429536862320489,0
1897,3794,-1897,1,0.7738642865191585,0
1898,3796,-1898,1,0.6312678722560743,0
1902,3804,-1902,1,0.8631487065952497,0
1904,3808,-1904,1,0.5633131493369211,0
1906,3812,-1906,1,0.8641899303776646,0
1910,3820,-1910,1,0.7491411131873881,0
1911,3822,-1911,1,0.18612558750321506,0
1913,3826,-1913,1,0.08565468273311083,0
1914,3828,-1914,1,0.3916994140681047,0
1915,3830,-1915,1,0.7742965872033257,0
1916,3832,-1916,1,0.5514797805921473,0
1917,3834,-1917,1,0.4044775442876848,0
1918,3836,-1918,1,0.28079674801905796,0
1922,3844,-1922,1,0.15321434510205512,0
1924,3848,-1924,1,0.4018638102012966,0
1925,3850,-1925,1,0.03951004396714586,0
1927,3854,-1927,1,0.4872469326011206,0
1930,3860,-1930,1,0.5572629461133739,0
1932,3864,-1932,1,0.7290055297954747,0
1933,3866,-1933,1,0.19810767879734337,0
1937,3874,-1937,1,0.940152608786959,0
1940,3880,-1940,1,0.5484700180795806,0
1944,3888,-1944,1,0.0822856871148886,0
1946,3892,-1946,1,0.8539085333325307,0
1950,3900,-1950,1,0.46249651370053557,0
1951,3902,-1951,1,0.5172168451701599,0
1953,3906,-1953,1,0.9764209658757784,0
1955,3910,-1955,1,0.5741382821357279,0
1959,3918,-1959,1,0.8508562246765845,0
1960,3920,-1960,1,0.6971444449671059,0
1963,3926,-1963,1,0.1491310278827045,0
1965,3930,-1965,1,0.624140012103834,0
1967,3934,-1967,1,0.05228985764845573,0
1970,3940,-1970,1,0.6246267621260237,0
1972,3944,-1972,1,0.7201848895510842,0
1973,3946,-1973,1,0.09208292698929799,0
1975,3950,-1975,1,0.06431607991249477,0
1977,3954,-1977,1,0.4250768285047163,0
1978,3956,-1978,1,0.3626687613194509,0
1982,3964,-1982,1,0.929567789350974,0
1984,3968,-1984,1,0.32485933218369645,0
1988,3976,-1988,1,0.7392433385867824,0
1992,3984,-1992,1,0.35963989272285624,0
1993,3986,-1993,1,0.5157423406316296,0
1994,3988,-1994,1,0.26889562161459,0
1996,3992,-1996,1,0.8264228231281949,0
1999,3998,-1999,1,0.11878751362414375,0
2004,4008,-2004,1,0.9591772033148201,0
2007,4014,-2007,1,0.43705983945045535,0
2009,4018,-2009,1,0.5581158304180965,0
2011,4022,-2011,1,0.27459482177622796,0
2017,4034,-2017,1,0.5565575675883084,0
2019,4038,-2019,1,0.47745936102485775,0
2025,4050,-2025,1,0.5473011055297698,0
2026,4052,-2026,1,0.38397718500143907,0
2030,4060,-2030,1,0.07451086178382027,0
2033,4066,-2033,1,0.06820210134247129,0
2038,4076,-2038,1,0.645298899235238,0
2043,4086,-2043,1,0.8905217282568765,0
2046,4092,-2046,1,0.11491057157801876,0
2047,4094,-2047,1,0.83165369920575,0
2050,4100,-2050,1,0.5623300380144942,0
2052,4104,-2052,1,0.9813467104246335,0
2056,4112,-2056,1,0.17431479183190102,0
2058,4116,-2058,1,0.9948822397609334,0
2062,4124,-2062,1,0.41578774121540885,0
2063,4126,-2063,1,0.12124217094786205,0
2066,4132,-2066,1,0.21009104811959556,0
2067,4134,-2067,1,0.4372749389768412,0
2068,4136,-2068,1,0.7574882173764618,0
2070,4140,-2070,1,0.43567132099108996,0
2073,4146,-2073,1,0.0434474472613412,0
2076,4152,-2076,1,0.32578924785909935,0
2081,4162,-2081,1,0.8259394067734734,0
2083,4166,-2083,1,0.6591588414320142,0
2086,4172,-2086,1,0.42478326228430874,0
2087,4174,-2087,1,0.5826327557148245,0
2089,4178,-2089,1,0.2228263116311603,0
2091,4182,-2091,1,0.8386930254385482,0
2093,4186,-2093,1,0.28036908122278714,0
2095,4190,-2095,1,0.5467909147600084,0
2097,4194,-2097,1,0.05459061432957624,0
2098,4196,-2098,1,0.4875321300840165,0
2099,4198,-2099,1,0.43354568551047856,0
2100,4200,-2100,1,0.764796506010969,0
2102,4204,-2102,1,0.42190998805620383,0
2104,4208,-2104,1,0.6062871384053591,0
2105,4210,-2105,1,0.628121213191839,0
2107,4214,-2107,1,0.5514651789964684,0
2111,4222,-2111,1,0.08467953249235094,0
2117,4234,-2117,1,0.844807772298832,0
2118,4236,-2118,1,0.4455391051562957,0
2119,4238,-2119,1,0.36788183885268755,0
2121,4242,-2121,1,0.8140824423855794,0
2123,4246,-2123,1,0.8009915006773358,0
2124,4248,-2124,1,0.4969761078256427,0
2125,4250,-2125,1,0.0629749813831133,0
2138,4276,-2138,1,0.36749072950429473,0
2141,4282,-2141,1,0.08353154767702142,0
2142,4284,-2142,1,0.7311160046621555,0
2144,4288,-2144,1,0.8011806771580119,0
2149,4298,-2149,1,0.898781969009744,0
2151,4302,-2151,1,0.7569888480810866,0
2155,4310,-2155,1,0.1299533697427766,0
2156,4312,-2156,1,0.27222449593846176,0
2160,4320,-2160,1,0.2144809699878668,0
2164,4328,-2164,1,0.5978191951381573,0
2165,4330,-2165,1,0.9561652770837786,0
2166,4332,-2166,1,0.39758671827941594,0
2171,4342,-2171,1,0.7348018682260351,0
2174,4348,-2174,1,0.6309249835441503,0
2175,4350,-2175,1,0.11785341031960217,0
2181,4362,-2181,1,0.938356027155147,0
2183,4366,-2183,1,0.8318562160789791,0
2194,4388,-2194,1,0.9635044699891577,0
2202,4404,-2202,1,0.5059142381623293,0
2203,4406,-2203,1,0.26142280031503784,0
2204,4408,-2204,1,0.02088387449787621,0
2206,4412,-2206,1,0.8440034686650917,0
2208,4416,-2208,1,0.37363662396751296,0
2210,4420,-2210,1,0.5233209256430322,0
2216,4432,-2216,1,0.056037180897060224,0
2220,4440,-2220,1,0.2726502190002018,0
2221,4442,-2221,1,0.5107560632290928,0
2224,4448,-2224,1,0.5257372643266024,0
2225,4450,-2225,1,0.7718647344560936,0
2237,4474,-2237,1,0.728326316240093,0
2244,4488,-2244,1,0.3412198093674069,0
2248,4496,-2248,1,0.8607022881203906,0
2249,4498,-2249,1,0.342853657630688,0
2250,4500,-2250,1,0.7537496524904986,0
2255,4510,-2255,1,0.5665688423824061,0
2259,4518,-2259,1,0.4845428406623732,0
2263,4526,-2263,1,0.20993314897517845,0
2270,4540,-2270,1,0.28133243988516354,0
2273,4546,-2273,1,0.9805449416362126,0
2276,4552,-2276,1,0.6572196819541242,0
2277,4554,-2277,1,0.6213192808638546,0
2278,4556,-2278,1,0.42309713841801944,0
2279,4558,-2279,1,0.4879051046180787,0
2281,4562,-2281,1,0.778224667914152,0
2282,4564,-2282,1,0.5597479977039634,0
2285,4570,-2285,1,0.1409166275303403,0
2286,4572,-2286,1,0.5652820436049592,0
2293,4586,-2293,1,0.9991017325885706,0
2295,4590,-2295,1,0.08054716205617041,0
2297,4594,-2297,1,0.9978622769236585,0
2316,4632,-2316,1,0.8650987271980105,0
2319,4638,-2319,1,0.38958168191229725,0
2321,4642,-2321,1,0.5900050535514924,0
2324,4648,-2324,1,0.6807787632896506,0
2326,4652,-2326,1,0.16544772181657386,0
2328,4656,-2328,1,0.7848932119890275,0
2330,4660,-2330,1,0.12431445776455485,0
2331,4662,-2331,1,0.8950132349940592,0
2340,4680,-2340,1,0.0010789354424555198,0
2342,4684,-2342,1,0.12489591381440424,0
2346,4692,-2346,1,0.5452283493619942,0
2353,4706,-2353,1,0.8363610294207102,0
2357,4714,-2357,1,0.516629333826202,0
2358,4716,-2358,1,0.27600448279683565,0
2359,4718,-2359,1,0.7458504846341703,0
2360,4720,-2360,1,0.39013359250204405,0
2361,4722,-2361,1,0.11471749268456377,0
2362,4724,-2362,1,0.5939655469518212,0
2364,4728,-2364,1,0.5560130818519117,0
2365,4730,-2365,1,0.48111147722600367,0
2368,4736,-2368,1,0.8090779465933373,0
2369,4738,-2369,1,0.06458066550125252,0
2370,4740,-2370,1,0.8748837370770385,0
2371,4742,-2371,1,0.30406696481052375,0
2372,4744,-2372,1,0.2176873242980778,0
2377,4754,-2377,1,0.9317805138106974,0
2380,4760,-2380,1,0.694987062382575,0
2387,4774,-2387,1,0.7077452324985345,0
2390,4780,-2390,1,0.1276704931100292,0
2391,4782,-2391,1,0.06557461744150705,0
2392,4784,-2392,1,0.3297170644211429,0
2394,4788,-2394,1,0.3917339510548149,0
2402,4804,-2402,1,0.13373595238015357,0
2404,4808,-2404,1,0.6951707466392009,0
2407,4814,-2407,1,0.7286917014318488,0
2410,4820,-2410,1,0.701781403510347,0
2412,4824,-2412,1,0.15999052995946894,0
2413,4826,-2413,1,0.7472323587836892,0
2415,4830,-2415,1,0.3715687010572558,0
2419,4838,-2419,1,0.012531749465004904,0
2420,4840,-2420,1,0.7736017839884964,0
2421,4842,-2421,1,0.20222913578059853,0
2427,4854,-2427,1,0.9118905618851173,0
2430,4860,-2430,1,0.5149353398582687,0
2433,4866,-2433,1,0.9299993340177416,0
2438,4876,-2438,1,0.35069745326389634,0
2439,4878,-2439,1,0.9819115516998077,0
2440,4880,-2440,1,0.7455393639691156,0
2453,4906,-2453,1,0.1641661595540388,0
2454,4908,-2454,1,0.5363121955040676,0
2464,4928,-2464,1,0.4784939278128587,0
2465,4930,-2465,1,0.9819566942974169,0
2466,4932,-2466,1,0.7411529843135383,0
2471,4942,-2471,1,0.5002303810409656,0
2472,4944,-2472,1,0.9847270601538162,0
2475,4950,-2475,1,0.40790132510617605,0
2476,4952,-2476,1,0.7770209178798527,0
2479,4958,-2479,1,0.540238872089208,0
2483,4966,-2483,1,0.2969072475431266,0
2492,4984,-2492,1,0.25566894946453744,0
2494,4988,-2494,1,0.4611771904778901,0
2496,4992,-2496,1,0.6344698640059406,0
2500,5000,-2500,1,0.0686116283064041,0
2501,5002,-2501,1,0.42407614986061537,0
2502,5004,-2502,1,0.8399531745350123,0
2505,5010,-2505,1,0.5058937796565978,0
2507,5014,-2507,1,0.24534229721885903,0
2508,5016,-2508,1,0.4002588573496769,0
2510,5020,-2510,1,0.7873350870037901,0
2511,5022,-2511,1,0.12959655898131117,0
2512,5024,-2512,1,0.6124063084329916,0
2514,5028,-2514,1,0.9783998082364195,0
2515,5030,-2515,1,0.3630807157570436,0
2519,5038,-2519,1,0.13890768728757974,0
2520,5040,-2520,1,0.25631710742867353,0
2527,5054,-2527,1,0.46899282396833786,0
2532,5064,-2532,1,0.2886863708957945,0
2533,5066,-2533,1,0.5772318386395374,0
2536,5072,-2536,1,0.4990583323029183,0
2537,5074,-2537,1,0.8477195223314993,0
2539,5078,-2539,1,0.03050865418008486,0
2541,5082,-2541,1,0.35200466622522664,0
2542,5084,-2542,1,0.7930375199383041,0
2543,5086,-2543,1,0.32095371187461175,0
2554,5108,-2554,1,0.10041171151625605,0
2557,5114,-2557,1,0.47421051652801005,0
2563,5126,-2563,1,0.2563459384647957,0
2567,5134,-2567,1,0.9364112088637515,0
2569,5138,-2569,1,0.5157851864141143,0
2570,5140,-2570,1,0.4384568915097212,0
2578,5156,-2578,1,0.8321356389415593,0
2579,5158,-2579,1,0.6517539067365977,0
2580,5160,-2580,1,0.1086754471028828,0
2581,5162,-2581,1,0.11909945650770337,0
2583,5166,-2583,1,0.8348503549784868,0
2584,5168,-2584,1,0.961521130239197,0
2587,5174,-2587,1,0.829667873285764,0
2590,5180,-2590,1,0.010711945933029376,0
2591,5182,-2591,1,0.16883906523604875,0
2592,5184,-2592,1,0.34855664515076756,0
2593,5186,-2593,1,0.1268221578503077,0
2595,5190,-2595,1,0.5193438068039841,0
2597,5194,-2597,1,0.1629540225332844,0
2598,5196,-2598,1,0.07982756161801785,0
2599,5198,-2599,1,0.6031653726444088,0
2602,5204,-2602,1,0.28460762536459916,0
2609,5218,-2609,1,0.6609950664240807,0
2618,5236,-2618,1,0.7693970742057517,0
2620,5240,-2620,1,0.06614382384581541,0
2622,5244,-2622,1,0.5644706896406378,0
2623,5246,-2623,1,0.5146047237798073,0
2625,5250,-2625,1,0.28472824898221816,0
2628,5256,-2628,1,0.8107164487818789,0
2630,5260,-2630,1,0.20850508316696215,0
2632,5264,-2632,1,0.035266409636002694,0
2643,5286,-2643,1,0.973363929281253,0
2653,5306,-2653,1,0.261503841506566,0
2655,5310,-2655,1,0.42738337645957236,0
2656,5312,-2656,1,0.280296504397922,0
2658,5316,-2658,1,0.5333924821868884,0
2660,5320,-2660,1,0.6614434881777983,0
2661,5322,-2661,1,0.49963285153753156,0
2663,5326,-2663,1,0.3934523198723415,0
2673,5346,-2673,1,0.5928901679297466,0
2674,5348,-2674,1,0.2684251175635507,0
2678,5356,-2678,1,0.760134368942957,0
2680,5360,-2680,1,0.44483098057616344,0
2683,5366,-2683,1,0.02429501093485209,0
2686,5372,-2686,1,0.6633395419211172,0
2695,5390,-2695,1,0.3282466525123414,0
2697,5394,-2697,1,0.20008613543548726,0
2698,5396,-2698,1,0.35138205103379416,0
2702,5404,-2702,1,0.5120052795701477,0
2704,5408,-2704,1,0.2231394359861788,0
2707,5414,-2707,1,0.12742201867338665,0
2712,5424,-2712,1,0.13481109444078154,0
2715,5430,-2715,1,0.6679370250759741,0
2716,5432,-2716,1,0.9341345444985689,0
2719,5438,-2719,1,0.18734846574008568,0
2721,5442,-2721,1,0.054383557822929585,0
2722,5444,-2722,1,0.1507270774690821,0
2724,5448,-2724,1,0.18305170262387904,0
2726,5452,-2726,1,0.9217413444933532,0
2728,5456,-2728,1,0.6011323251115399,0
2738,5476,-2738,1,0.5325228052331521,0
2744,5488,-2744,1,0.0777400568291422,0
2755,5510,-2755,1,0.4367188348438995,0
2758,5516,-2758,1,0.7070420977556665,0
2760,5520,-2760,1,0.9467277927472747,0
2762,5524,-2762,1,0.2379969108907637,0
2763,5526,-2763,1,0.7960638606525002,0
2764,5528,-2764,1,0.3005230494927672,0
2767,5534,-2767,1,0.3355645125062847,0
2769,5538,-2769,1,0.7324322750640263,0
2770,5540,-2770,1,0.6261523699521804,0
2771,5542,-2771,1,0.8621672557358727,0
2776,5552,-2776,1,0.8915021221511349,0
2781,5562,-2781,1,0.3482362502342423,0
2782,5564,-2782,1,0.1791242789644828,0
2786,5572,-2786,1,0.6837899623438609,0
2788,5576,-2788,1,0.911236204890671,0
2790,5580,-2790,1,0.8305213088754856,0
2793,5586,-2793,1,0.8509260936598567,0
2796,5592,-2796,1,0.3689520262466288,0
2797,5594,-2797,1,0.25592634659777935,0
2799,5598,-2799,1,0.48442677942014767,0
2803,5606,-2803,1,0.41584339762504763,0
2806,5612,-2806,1,0.974352024015095,0
2809,5618,-2809,1,0.24669891240104025,0
2812,5624,-2812,1,0.8983278092317831,0
2815,5630,-2815,1,0.9596188813508214,0
2819,5638,-2819,1,0.7274160194305619,0
2822,5644,-2822,1,0.7352840664964979,0
2823,5646,-2823,1,0.4467153979074532,0
2835,5670,-2835,1,0.4403588663298299,0
2836,5672,-2836,1,0.5007506503859593,0
2838,5676,-2838,1,0.5934516708696734,0
2841,5682,-2841,1,0.3117355561535944,0
2842,5684,-2842,1,0.9440289770129011,0
2846,5692,-2846,1,0.6963576806115263,0
2848,5696,-2848,1,0.2293647597078955,0
2852,5704,-2852,1,0.512877876527885,0
2854,5708,-2854,1,0.06484598097834604,0
2856,5712,-2856,1,0.2991632115989039,0
2859,5718,-2859,1,0.20020460567399267,0
2860,5720,-2860,1,0.16446836869263348,0
2862,5724,-2862,1,0.1857547087569028,0
2863,5726,-2863,1,0.6016791203914882,0
2876,5752,-2876,1,0.7548108790376044,0
2878,5756,-2878,1,0.9187591532368933,0
2880,5760,-2880,1,0.04993152290054059,0
2881,5762,-2881,1,0.6958431727090637,0
2883,5766,-2883,1,0.2390372025783999,0
2888,5776,-2888,1,0.5028529957787798,0
2891,5782,-2891,1,0.643288000962109,0
2894,5788,-2894,1,0.7199601946829401,0
2896,5792,-2896,1,0.4441225900693607,0
2898,5796,-2898,1,0.30458489916450815,0
2899,5798,-2899,1,0.43312889341990557,0
2901,5802,-2901,1,0.6076832613276579,0
2905,5810,-2905,1,0.4209278265710228,0
2906,5812,-2906,1,0.09511169933334884,0
2909,5818,-2909,1,0.8811741870726977,0
2911,5822,-2911,1,0.8710553530016475,0
2912,5824,-2912,1,0.9599124114120958,0
2917,5834,-2917,1,0.14915228336618336,0
2920,5840,-2920,1,0.4014433670705154,0
2925,5850,-2925,1,0.9783182877149681,0
2935,5870,-2935,1,0.5931902265084599,0
2937,5874,-2937,1,0.08047949723053427,0
2938,5876,-2938,1,0.5160895579643332,0
2939,5878,-2939,1,0.6904336713985348,0
2941,5882,-2941,1,0.8404358473605471,0
2943,5886,-2943,1,0.01311048982833396,0
2944,5888,-2944,1,0.44178495116625405,0
2945,5890,-2945,1,0.19104693648702553,0
2951,5902,-2951,1,0.3652054200751297,0
2952,5904,-2952,1,0.7272262749599444,0
2953,5906,-2953,1,0.5142893814834034,0
2954,5908,-2954,1,0.17724241719396872,0
2955,5910,-2955,1,0.13081106645404772,0
2960,5920,-2960,1,0.9983639407470736,0
2961,5922,-2961,1,0.014714547617828422,0
2962,5924,-2962,1,0.6783284150868202,0
2964,5928,-2964,1,0.2782692984143793,0
2966,5932,-2966,1,0.7469498248542491,0
2969,5938,-2969,1,0.5375415535524967,0
2970,5940,-2970,1,0.9153549198849278,0
2975,5950,-2975,1,0.3620488895445779,0
2978,5956,-2978,1,0.2791551727209539,0
2982,5964,-2982,1,0.3123715225316388,0
2985,5970,-2985,1,0.8361462776752331,0
2986,5972,-2986,1,0.08226222802193484,0
2993,5986,-2993,1,0.8187910197755294,0
2995,5990,-2995,1,0.06275089697471203,0
2996,5992,-2996,1,0.1120439199580654,0
2999,5998,-2999,1,0.6323105440193981,0
3000,6000,-3000,1,0.7776006934276172,1
3002,6004,-3002,1,0.19251107350686114,1
3017,6034,-3017,1,0.6653470232056463,1
3024,6048,-3024,1,0.7995664268880516,1
3028,6056,-3028,1,0.5233736661167565,1
3032,6064,-3032,1,0.883030547266689,1
3034,6068,-3034,1,0.5132737612081564,1
3035,6070,-3035,1,0.8908896238743093,1
3039,6078,-3039,1,0.2770990737469775,1
3041,6082,-3041,1,0.3000270292279351,1
3042,6084,-3042,1,0.9014259949170104,1
3043,6086,-3043,1,0.36334116570403263,1
3044,6088,-3044,1,0.23006068759238096,1
3045,6090,-3045,1,0.2763410636744099,1
3051,6102,-3051,1,0.43751350434010783,1
3055,6110,-3055,1,0.7122592516120388,1
3058,6116,-3058,1,0.5172077485561073,1
3062,6124,-3062,1,0.9760026610271918,1
3064,6128,-3064,1,0.33825391981413677,1
3065,6130,-3065,1,0.49204327592256525,1
3066,6132,-3066,1,0.24532174664655781,1
3068,6136,-3068,1,0.7924947455568979,1
3069,6138,-3069,1,0.46258482128023326,1
3071,6142,-3071,1,0.961780906261809,1
3072,6144,-3072,1,0.2644354954594983,1
3076,6152,-3076,1,0.2267002288536466,1
3077,6154,-3077,1,0.6722542237684214,1
3079,6158,-3079,1,0.17993945547996892,1
3082,6164,-3082,1,0.1179089241089315,1
3083,6166,-3083,1,0.14226937048489563,1
3084,6168,-3084,1,0.017245337722279985,1
3085,6170,-3085,1,0.70905979608954,1
3087,6174,-3087,1,0.11773622691774333,1
3090,6180,-3090,1,0.37118400034601706,1
3092,6184,-3092,1,0.15926823375549282,1
3099,6198,-3099,1,0.0613459594006428,1
3102,6204,-3102,1,0.8039066903399787,1
3107,6214,-3107,1,0.037758375403470046,1
3108,6216,-3108,1,0.728863391446907,1
3112,6224,-3112,1,0.7267372998370136,1
3113,6226,-3113,1,0.4120854643585259,1
3114,6228,-3114,1,0.7891362577685662,1
3116,6232,-3116,1,0.6644749622540737,1
3117,6234,-3117,1,0.5444146662196254,1
3119,6238,-3119,1,0.5698611326032945,1
3121,6242,-3121,1,0.4683447659561779,1
3122,6244,-3122,1,0.9790396531633042,1
3127,6254,-3127,1,0.39389581810354846,1
3128,6256,-3128,1,0.39474987979829534,1
3133,6266,-3133,1,0.7410086146459638,1
3140,6280,-3140,1,0.5857231001059827,1
3142,6284,-3142,1,0.2487736979096591,1
3148,6296,-3148,1,0.19056420009948294,1
3152,6304,-3152,1,0.30327593686201126,1
3158,6316,-3158,1,0.7655648177676736,1
3162,6324,-3162,1,0.4487101913750702,1
3166,6332,-3166,1,0.8174174511676309,1
3167,6334,-3167,1,0.9847045446589623,1
3168,6336,-3168,1,0.2196847715488367,1
3169,6338,-3169,1,0.49601875435305653,1
3174,6348,-3174,1,0.0494200685817352,1
3175,6350,-3175,1,0.42656308456502456,1
3176,6352,-3176,1,0.407516804554511,1
3178,6356,-3178,1,0.8811608417870489,1
3187,6374,-3187,1,0.6390927714162133,1
3190,6380,-3190,1,0.6339401548251511,1
3193,6386,-3193,1,0.9480274380821785,1
3194,6388,-3194,1,0.5454765055911154,1
3196,6392,-3196,1,0.24487752320065492,1
3198,6396,-3198,1,0.03737641110998369,1
3199,6398,-3199,1,0.31910439009603575,1
3209,6418,-3209,1,0.2258483077466784,1
3211,6422,-3211,1,0.8496166250720171,1
3212,6424,-3212,1,0.5972126384177225,1
3213,6426,-3213,1,0.02597647121277502,1
3219,6438,-3219,1,0.009983324333672772,1
3223,6446,-3223,1,0.09671314227008243,1
3225,6450,-3225,1,0.47886503660019586,1
3231,6462,-3231,1,0.2855678299465164,1
3238,6476,-3238,1,0.31643271766667425,1
3241,6482,-3241,1,0.21656272444733005,1
3247,6494,-3247,1,0.19757163620854978,1
3249,6498,-3249,1,0.15897360308822883,1
3251,6502,-3251,1,0.6057737310696113,1
3252,6504,-3252,1,0.376548717985387,1
3257,6514,-3257,1,0.8437865112762373,1
3258,6516,-3258,1,0.017957006913724483,1
3259,6518,-3259,1,0.017396509399676963,1
3262,6524,-3262,1,0.5883140285381887,1
3263,6526,-3263,1,0.07355352293913431,1
3266,6532,-3266,1,0.5586602870251222,1
3267,6534,-3267,1,0.9376109066932075,1
3268,6536,-3268,1,0.24168784343493777,1
3269,6538,-3269,1,0.9780684949903786,1
3273,6546,-3273,1,0.792713442051546,1
3274,6548,-3274,1,0.26699522222531336,1
3276,6552,-3276,1,0.0774491802659073,1
3279,6558,-3279,1,0.11206522581323031,1
3280,6560,-3280,1,0.20880355455116695,1
3283,6566,-3283,1,0.08558118564656203,1
3284,6568,-3284,1,0.7144739852491787,1
3285,6570,-3285,1,0.531410895622034,1
3288,6576,-3288,1,0.9914508736772188,1
3292,6584,-3292,1,0.47310089438629943,1
3298,6596,-3298,1,0.1151864228469166,1
3300,6600,-3300,1,0.0039592542179869294,1
3308,6616,-3308,1,0.04710131046949939,1
3310,6620,-3310,1,0.8554054561000797,1
3312,6624,-3312,1,0.03827626772608206,1
3316,6632,-3316,1,0.5021252448627946,1
3318,6636,-3318,1,0.6938191190621112,1
3319,6638,-3319,1,0.7555230707132985,1
3322,6644,-3322,1,0.280247232216597,1
3324,6648,-3324,1,0.7756237035026059,1
3325,6650,-3325,1,0.5047542959972008,1
3326,6652,-3326,1,0.9223922512016721,1
3327,6654,-3327,1,0.7984917634058332,1
3329,6658,-3329,1,0.4281272739604822,1
3340,6680,-3340,1,0.6627894326811941,1
3344,6688,-3344,1,0.03736330045838021,1
3347,6694,-3347,1,0.3603657170242497,1
3348,6696,-3348,1,0.23312166433021075,1
3358,6716,-3358,1,0.8367375250957416,1
3359,6718,-3359,1,0.8033719854402632,1
3360,6720,-3360,1,0.4972377280935232,1
3371,6742,-3371,1,0.2574668487678632,1
3372,6744,-3372,1,0.08683428974107199,1
3377,6754,-3377,1,0.8501081965904225,1
3379,6758,-3379,1,0.947461786011821,1
3387,6774,-3387,1,0.11755428358620457,1
3390,6780,-3390,1,0.7104413324050237,1
3391,6782,-3391,1,0.4733634962635417,1
3395,6790,-3395,1,0.6125362415419622,1
3398,6796,-3398,1,0.28625579130393586,1
3399,6798,-3399,1,0.18222665655667813,1
3408,6816,-3408,1,0.011512910473498228,1
3412,6824,-3412,1,0.8351150509139625,1
3415,6830,-3415,1,0.31037799719989345,1
3420,6840,-3420,1,0.4326905634563486,1
3424,6848,-3424,1,0.9078539465622885,1
3425,6850,-3425,1,0.742386441222234,1
3428,6856,-3428,1,0.22873050046754406,1
3429,6858,-3429,1,0.5164119738282656,1
3430,6860,-3430,1,0.9455048322750926,1
3433,6866,-3433,1,0.12026889340423996,1
3435,6870,-3435,1,0.08076541662360415,1
3439,6878,-3439,1,0.8910983977635598,1
3440,6880,-3440,1,0.5231101400324475,1
3444,6888,-3444,1,0.16232282555357513,1
3446,6892,-3446,1,0.9794930146779525,1
3447,6894,-3447,1,0.43820313676289746,1
3456,6912,-3456,1,0.18247499288846647,1
3462,6924,-3462,1,0.822785335795365,1
3463,6926,-3463,1,0.07980623502663065,1
3469,6938,-3469,1,0.9488031394163348,1
3470,6940,-3470,1,0.45100474384500155,1
3471,6942,-3471,1,0.8843778415775333,1
3473,6946,-3473,1,0.3259899389188361,1
3475,6950,-3475,1,0.18311123946917762,1
3476,6952,-3476,1,0.812269434332295,1
3480,6960,-3480,1,0.11909402037450112,1
3481,6962,-3481,1,0.8444826594174286,1
3482,6964,-3482,1,0.2361909376229343,1
3483,6966,-3483,1,0.6729590444771587,1
3484,6968,-3484,1,0.8695750178105004,1
3493,6986,-3493,1,0.17547729754482022,1
3498,6996,-3498,1,0.9856887996802203,1
3502,7004,-3502,1,0.4666952023609655,1
3505,7010,-3505,1,0.23468541516119346,1
3506,7012,-3506,1,0.5973212815411791,1
3509,7018,-3509,1,0.7793285272806328,1
3512,7024,-3512,1,0.32264762810234127,1
3518,7036,-3518,1,0.4595018301616701,1
3519,7038,-3519,1,0.4772743626385665,1
3523,7046,-3523,1,0.15841113204552737,1
3524,7048,-3524,1,0.6992831580751695,1
3526,7052,-3526,1,0.3873725692917529,1
3527,7054,-3527,1,0.3789103419755877,1
3538,7076,-3538,1,0.23185966524679025,1
3540,7080,-3540,1,0.002095196573001279,1
3541,7082,-3541,1,0.7111584793655825,1
3543,7086,-3543,1,0.04752008245460415,1
3545,7090,-3545,1,0.26813531103284916,1
3547,7094,-3547,1,0.9764598054180538,1
3549,7098,-3549,1,0.650552947490293,1
3550,7100,-3550,1,0.1875651376766041,1
3552,7104,-3552,1,0.16758351349715006,1
3559,7118,-3559,1,0.5958385959814815,1
3563,7126,-3563,1,0.15608207174503586,1
3566,7132,-3566,1,0.9090562187348338,1
3567,7134,-3567,1,0.7436011384645631,1
3569,7138,-3569,1,0.27370517847537934,1
3571,7142,-3571,1,0.9598577485695856,1
3574,7148,-3574,1,0.31022254736826105,1
3579,7158,-3579,1,0.7772595271080514,1
3581,7162,-3581,1,0.3015539486018649,1
3583,7166,-3583,1,0.5782583852953926,1
3585,7170,-3585,1,0.4454876162667225,1
3586,7172,-3586,1,0.1328625157620802,1
3592,7184,-3592,1,0.5490182939641862,1
3595,7190,-3595,1,0.4870390569869263,1
3596,7192,-3596,1,0.7579004296048687,1
3599,7198,-3599,1,0.8098912229532776,1
3608,7216,-3608,1,0.029401336553820823,1
3610,7220,-3610,1,0.9482762617329729,1
3614,7228,-3614,1,0.1674853552311686,1
3619,7238,-3619,1,0.42959843169865475,1
3625,7250,-3625,1,0.6801740959036441,1
3627,7254,-3627,1,0.033763563149498244,1
3629,7258,-3629,1,0.9562146613519508,1
3634,7268,-3634,1,0.8807592548788493,1
3641,7282,-3641,1,0.503613468918,1
3646,7292,-3646,1,0.73220993268462,1
3647,7294,-3647,1,0.8245118400810666,1
3651,7302,-3651,1,0.01019677522652529,1
3653,7306,-3653,1,0.07778883700791928,1
3654,7308,-3654,1,0.954459548186987,1
3656,7312,-3656,1,0.9335395323093872,1
3658,7316,-3658,1,0.9877274067465482,1
3660,7320,-3660,1,0.7758832434132744,1
3661,7322,-3661,1,0.431561056970447,1
3665,7330,-3665,1,0.7522120407426685,1
3666,7332,-3666,1,0.7644605667035844,1
3667,7334,-3667,1,0.5282593657083754,1
3668,7336,-3668,1,0.9140778356969315,1
3669,7338,-3669,1,0.2283028727533305,1
3670,7340,-3670,1,0.5220657809383809,1
3674,7348,-3674,1,0.08087844992995241,1
3675,7350,-3675,1,0.5807675979970238,1
3678,7356,-3678,1,0.47195568496376983,1
3680,7360,-3680,1,0.8797706340469512,1
3683,7366,-3683,1,0.8022774629411474,1
3691,7382,-3691,1,0.6323074385093568,1
3696,7392,-3696,1,0.5670970514334657,1
3699,7398,-3699,1,0.836056376919303,1
3701,7402,-3701,1,0.34330009903676895,1
3703,7406,-3703,1,0.16761043359740935,1
3705,7410,-3705,1,0.8887705972547572,1
3706,7412,-3706,1,0.7446336195749635,1
3712,7424,-3712,1,0.91253955522992,1
3713,7426,-3713,1,0.20164297123485575,1
3717,7434,-3717,1,0.4842111694872937,1
3722,7444,-3722,1,0.4968100411173112,1
3724,7448,-3724,1,0.6735356087341958,1
3727,7454,-3727,1,0.27943893044959534,1
3730,7460,-3730,1,0.7252064370696625,1
3731,7462,-3731,1,0.8100177362652493,1
3733,7466,-3733,1,0.2743388699779534,1
3734,7468,-3734,1,0.3815120850880189,1
3735,7470,-3735,1,0.7597055094532333,1
3736,7472,-3736,1,0.6225891571572877,1
3737,7474,-3737,1,0.8311597902111132,1
3740,7480,-3740,1,0.9727625100008069,1
3745,7490,-3745,1,0.16416925982128283,1
3747,7494,-3747,1,0.36988319755912136,1
3751,7502,-3751,1,0.02584494916529745,1
3753,7506,-3753,1,0.8959651561021762,1
3757,7514,-3757,1,0.20262757470402926,1
3758,7516,-3758,1,0.5726146531001912,1
3759,7518,-3759,1,0.5584057636675627,1
3767,7534,-3767,1,0.27249765272488957,1
3768,7536,-3768,1,0.11443324239493691,1
3775,7550,-3775,1,0.24216635867324177,1
3778,7556,-3778,1,0.21647485597483185,1
3779,7558,-3779,1,0.8101223839590829,1
3780,7560,-3780,1,0.995215075296192,1
3783,7566,-3783,1,0.43933746319532074,1
3785,7570,-3785,1,0.07089304797777729,1
3788,7576,-3788,1,0.6445504842281065,1
3791,7582,-3791,1,0.7319149675504466,1
3798,7596,-3798,1,0.9074775691562104,1
3800,7600,-3800,1,0.10072339777764028,1
3801,7602,-3801,1,0.28213279000316827,1
3806,7612,-3806,1,0.24096467161926338,1
3808,7616,-3808,1,0.4835533231867535,1
3813,7626,-3813,1,0.46765731540770106,1
3814,7628,-3814,1,0.9298058248405633,1
3817,7634,-3817,1,0.45672119196241556,1
3819,7638,-3819,1,0.22145519275004666,1
3821,7642,-3821,1,0.3380732997408328,1
3823,7646,-3823,1,0.21731673854871458,1
3827,7654,-3827,1,0.4328309087087616,1
3829,7658,-3829,1,0.40940380434908397,1
3830,7660,-3830,1,0.9250563195437844,1
3831,7662,-3831,1,0.10878778443046222,1
3838,7676,-3838,1,0.2578871233908727,1
3839,7678,-3839,1,0.14762494754817368,1
3848,7696,-3848,1,0.6769726737897521,1
3857,7714,-3857,1,0.2555426171870977,1
3864,7728,-3864,1,0.6312395101338046,1
3867,7734,-3867,1,0.6156167820207123,1
3873,7746,-3873,1,0.03416454070198205,1
3874,7748,-3874,1,0.7260826526279435,1
3880,7760,-3880,1,0.1994118817454028,1
3888,7776,-3888,1,0.7465168587873773,1
3890,7780,-3890,1,0.6118012416557912,1
3894,7788,-3894,1,0.6649626515103615,1
3896,7792,-3896,1,0.5618277657820825,1
3899,7798,-3899,1,0.7710899161453814,1
3902,7804,-3902,1,0.06884934485555805,1
3903,7806,-3903,1,0.7093765889467816,1
3904,7808,-3904,1,0.38662560987211914,1
3907,7814,-3907,1,0.8893442458906238,1
3908,7816,-3908,1,0.6809524934749099,1
3910,7820,-3910,1,0.5224161256280739,1
3913,7826,-3913,1,0.5471954132801445,1
3914,7828,-3914,1,0.27375837925764956,1
3925,7850,-3925,1,0.4347670421559381,1
3929,7858,-3929,1,0.8137356419260628,1
3933,7866,-3933,1,0.20978555192454573,1
3935,7870,-3935,1,0.14087696416124185,1
3937,7874,-3937,1,0.8030033701181692,1
3946,7892,-3946,1,0.7101756028914149,1
3950,7900,-3950,1,0.1587002084690835,1
3952,7904,-3952,1,0.27716823923123224,1
3955,7910,-3955,1,0.55274185311402,1
3957,7914,-3957,1,0.6136324648048553,1
3965,7930,-3965,1,0.10731913009242744,1
3967,7934,-3967,1,0.15469194166678868,1
3969,7938,-3969,1,0.6123054893854092,1
3973,7946,-3973,1,0.010529236716145696,1
3974,7948,-3974,1,0.7780784870686789,1
3976,7952,-3976,1,0.6687145966185888,1
3977,7954,-3977,1,0.9149256821992887,1
3978,7956,-3978,1,0.7612825959266137,1
3983,7966,-3983,1,0.9835554663748932,1
3984,7968,-3984,1,0.8762004816683848,1
3986,7972,-3986,1,0.7908684683348489,1
3988,7976,-3988,1,0.3196521357001001,1
3991,7982,-3991,1,0.1500820322479024,1
3993,7986,-3993,1,0.8231345309514488,1
3997,7994,-3997,1,0.9528845789063731,1
4000,8000,-4000,1,0.4481396561474784,1
4002,8004,-4002,1,0.09577125464081326,1
4003,8006,-4003,1,0.6881061162160206,1
4014,8028,-4014,1,0.5675154858796885,1
4016,8032,-4016,1,0.6275078991569176,1
4020,8040,-4020,1,0.805765934577098,1
4022,8044,-4022,1,0.5456722441277331,1
4023,8046,-4023,1,0.4480189263025157,1
4024,8048,-4024,1,0.756634814995877,1
4028,8056,-4028,1,0.608176056709949,1
4031,8062,-4031,1,0.8469220506001308,1
4041,8082,-4041,1,0.24781579290549405,1
4048,8096,-4048,1,0.11496184594203962,1
4050,8100,-4050,1,0.7446922284038805,1
4051,8102,-4051,1,0.15422290604385547,1
4052,8104,-4052,1,0.2868738937200017,1
4065,8130,-4065,1,0.8385668912687427,1
4071,8142,-4071,1,0.8121406012021588,1
4072,8144,-4072,1,0.7088740862981405,1
4076,8152,-4076,1,0.7505753773087939,1
4078,8156,-4078,1,0.7958608148604464,1
4083,8166,-4083,1,0.10260266114012007,1
4086,8172,-4086,1,0.8108198422628917,1
4092,8184,-4092,1,0.06582302951129915,1
4098,8196,-4098,1,0.9825777536622946,1
4102,8204,-4102,1,0.7043400109306243,1
4103,8206,-4103,1,0.23250517850265273,1
4105,8210,-4105,1,0.717004890388303,1
4107,8214,-4107,1,0.7875219043259666,1
4108,8216,-4108,1,0.9022713229889836,1
4109,8218,-4109,1,0.24741615520934712,1
4110,8220,-4110,1,0.1067935301185372,1
4114,8228,-4114,1,0.23232532117099491,1
4115,8230,-4115,1,0.550562094285509,1
4116,8232,-4116,1,0.680749097498109,1
4118,8236,-4118,1,0.05501073042435645,1
4120,8240,-4120,1,0.6443632129125918,1
4122,8244,-4122,1,0.543611147381197,1
4125,8250,-4125,1,0.5491833345356736,1
4128,8256,-4128,1,0.5954435148570053,1
4129,8258,-4129,1,0.29096382535959464,1
4131,8262,-4131,1,0.1651997706979237,1
4135,8270,-4135,1,0.6984474212311534,1
4136,8272,-4136,1,0.3438831104643162,1
4139,8278,-4139,1,0.9428439885529164,1
4142,8284,-4142,1,0.5648382983401028,1
4143,8286,-4143,1,0.4854256099476879,1
4145,8290,-4145,1,0.5727590440038446,1
4146,8292,-4146,1,0.1439270767724028,1
4150,8300,-4150,1,0.5809373030678758,1
4152,8304,-4152,1,0.10099003824948727,1
4156,8312,-4156,1,0.32001387256520764,1
4157,8314,-4157,1,0.16362324414392648,1
4161,8322,-4161,1,0.9432388618808689,1
4165,8330,-4165,1,0.6675310978867045,1
4166,8332,-4166,1,0.8738470069774004,1
4170,8340,-4170,1,0.36830856405297363,1
4174,8348,-4174,1,0.7975235559012885,1
4176,8352,-4176,1,0.36222589631149615,1
4177,8354,-4177,1,0.6370911017310243,1
4182,8364,-4182,1,0.47041552236327466,1
4185,8370,-4185,1,0.748918581062207,1
4190,8380,-4190,1,0.35413647138642,1
4193,8386,-4193,1,0.9269774585387605,1
4195,8390,-4195,1,0.07573075505725113,1
4196,8392,-4196,1,0.48617730544198823,1
4197,8394,-4197,1,0.6370959844515576,1
4201,8402,-4201,1,0.8925944093142364,1
4206,8412,-4206,1,0.24581325363813522,1
4208,8416,-4208,1,0.11493011359619743,1
4216,8432,-4216,1,0.5887025431021642,1
4217,8434,-4217,1,0.4570650990167472,1
4218,8436,-4218,1,0.8832628596141344,1
4220,8440,-4220,1,0.1383089586893812,1
4223,8446,-4223,1,0.8398207253699232,1
4227,8454,-4227,1,0.5203780020061223,1
4230,8460,-4230,1,0.37773366604574643,1
4231,8462,-4231,1,0.6320396345276178,1
4234,8468,-4234,1,0.4900721335737299,1
4235,8470,-4235,1,0.2888059527699043,1
4237,8474,-4237,1,0.5714434219778372,1
4238,8476,-4238,1,0.6489721080512294,1
4243,8486,-4243,1,0.4798354369232879,1
4246,8492,-4246,1,0.6673448682518905,1
4254,8508,-4254,1,0.5960596239379989,1
4260,8520,-4260,1,0.5329837231005793,1
4261,8522,-4261,1,0.5299296823292649,1
4263,8526,-4263,1,0.08149383324021642,1
4264,8528,-4264,1,0.5534707037423124,1
4267,8534,-4267,1,0.3311083416213336,1
4271,8542,-4271,1,0.07342544191096534,1
4272,8544,-4272,1,0.5509424583062438,1
4279,8558,-4279,1,0.06728112982893608,1
4280,8560,-4280,1,0.47460972614255936,1
4281,8562,-4281,1,0.2694824048960982,1
4282,8564,-4282,1,0.5241219125406078,1
4283,8566,-4283,1,0.9767831830694828,1
4285,8570,-4285,1,0.23572714444307952,1
4286,8572,-4286,1,0.6964500565119637,1
4290,8580,-4290,1,0.9815069157051829,1
4291,8582,-4291,1,0.2220186612482168,1
4292,8584,-4292,1,0.571603360359456,1
4293,8586,-4293,1,0.2888726279750443,1
4295,8590,-4295,1,0.1784971713085982,1
4301,8602,-4301,1,0.2532210687426427,1
4302,8604,-4302,1,0.7726249311490224,1
4303,8606,-4303,1,0.6626552787962448,1
4307,8614,-4307,1,0.1731867544522916,1
4312,8624,-4312,1,0.7836692894317826,1
4314,8628,-4314,1,0.13839307724628047,1
4316,8632,-4316,1,0.7373374943010513,1
4318,8636,-4318,1,0.9508801157739897,1
4320,8640,-4320,1,0.6812374091599159,1
4322,8644,-4322,1,0.4697092778318068,1
4325,8650,-4325,1,0.4949816733821406,1
4331,8662,-4331,1,0.5224711206317125,1
4334,8668,-4334,1,0.5981033200745308,1
4336,8672,-4336,1,0.9835469681328997,1
4340,8680,-4340,1,0.7662459165132934,1
4341,8682,-4341,1,0.6174729559515726,1
4344,8688,-4344,1,0.6766532176363926,1
4345,8690,-4345,1,0.32218246521638505,1
4347,8694,-4347,1,0.029394855340467596,1
4348,8696,-4348,1,0.6795060846298601,1
4357,8714,-4357,1,0.456389548731978,1
4361,8722,-4361,1,0.8857523784445415,1
4362,8724,-4362,1,0.6552038179616763,1
4364,8728,-4364,1,0.04878386233182652,1
4366,8732,-4366,1,0.7491550224486051,1
4367,8734,-4367,1,0.9718588677379096,1
4379,8758,-4379,1,0.37070178375454776,1
4380,8760,-4380,1,0.46110137367751036,1
4381,8762,-4381,1,0.8294683879049212,1
4382,8764,-4382,1,0.03680499510534718,1
4385,8770,-4385,1,0.16133413831124632,1
4386,8772,-4386,1,0.49047030856354457,1
4387,8774,-4387,1,0.8901251306280039,1
4393,8786,-4393,1,0.0243603878600106,1
4394,8788,-4394,1,0.35679336563699904,1
4395,8790,-4395,1,0.9490259493898238,1
4399,8798,-4399,1,0.24831359362663197,1
4402,8804,-4402,1,0.8922437862236693,1
4403,8806,-4403,1,0.38320678901215943,1
4404,8808,-4404,1,0.8777613217296215,1
4414,8828,-4414,1,0.9871297734233425,1
4417,8834,-4417,1,0.42339814217816396,1
4418,8836,-4418,1,0.8208451856077672,1
4420,8840,-4420,1,0.08853611445115372,1
4423,8846,-4423,1,0.3631478515180775,1
4424,8848,-4424,1,0.33229796731596584,1
4427,8854,-4427,1,0.7923882804657291,1
4430,8860,-4430,1,0.08677059054003156,1
4432,8864,-4432,1,0.42849415666154167,1
4439,8878,-4439,1,0.50632393341673,1
4444,8888,-4444,1,0.8194846145478981,1
4448,8896,-4448,1,0.11804470884485341,1
4451,8902,-4451,1,0.7590920004361226,1
4458,8916,-4458,1,0.9786173581238168,1
4459,8918,-4459,1,0.26419889977116773,1
4460,8920,-4460,1,0.8730898733231208,1
4463,8926,-4463,1,0.7508704502730097,1
4465,8930,-4465,1,0.3176161398300854,1
4472,8944,-4472,1,0.2328392751057644,1
4475,8950,-4475,1,0.3557208706289674,1
4476,8952,-4476,1,0.10336326826197495,1
4477,8954,-4477,1,0.9764225871376901,1
4480,8960,-4480,1,0.4638008018248324,1
4481,8962,-4481,1,0.8611869504759904,1
4483,8966,-4483,1,0.36514371472455764,1
4488,8976,-4488,1,0.4888314440866217,1
4489,8978,-4489,1,0.04478263579535868,1
4492,8984,-4492,1,0.7070647802613846,1
4499,8998,-4499,1,0.2849742629348323,1
4502,9004,-4502,1,0.46120367732152545,1
4503,9006,-4503,1,0.92654818354817,1
4504,9008,-4504,1,0.18931285391227026,1
4506,9012,-4506,1,0.8058096590462623,1
4508,9016,-4508,1,0.7886919651384747,1
4509,9018,-4509,1,0.7234139705205415,1
4510,9020,-4510,1,0.9286332691554441,1
4515,9030,-4515,1,0.19074667689628777,1
4516,9032,-4516,1,0.9555312762478066,1
4517,9034,-4517,1,0.41933212340082393,1
4519,9038,-4519,1,0.35452446824295136,1
4522,9044,-4522,1,0.5019847829854359,1
4523,9046,-4523,1,0.41095644907391937,1
4525,9050,-4525,1,0.4356897360726735,1
4526,9052,-4526,1,0.08407498120834112,1
4528,9056,-4528,1,0.2920754327783798,1
4529,9058,-4529,1,0.7226051169681432,1
4537,9074,-4537,1,0.1683628053246079,1
4549,9098,-4549,1,0.240900169291967,1
4550,9100,-4550,1,0.6824056821434273,1
4551,9102,-4551,1,0.14299686126566435,1
4559,9118,-4559,1,0.9609455110901202,1
4562,9124,-4562,1,0.8535880805119704,1
4565,9130,-4565,1,0.7174403324273436,1
4571,9142,-4571,1,0.3148392362372501,1
4573,9146,-4573,1,0.2520807703191874,1
4574,9148,-4574,1,0.08706725701487317,1
4575,9150,-4575,1,0.4204057055707634,1
4580,9160,-4580,1,0.3354119028133393,1
4593,9186,-4593,1,0.32835846537686364,1
4594,9188,-4594,1,0.03353088479555222,1
4597,9194,-4597,1,0.09351211843274487,1
4600,9200,-4600,1,0.7908330841594506,1
4603,9206,-4603,1,0.8881655330656136,1
4604,9208,-4604,1,0.990058458726516,1
4605,9210,-4605,1,0.8468228835941423,1
4608,9216,-4608,1,0.9852498122567512,1
4609,9218,-4609,1,0.28682135676616616,1
4610,9220,-4610,1,0.04992323824385836,1
4611,9222,-4611,1,0.08997743294010152,1
4615,9230,-4615,1,0.7950163050694362,1
4616,9232,-4616,1,0.1266830091947514,1
4618,9236,-4618,1,0.4017303427620047,1
4620,9240,-4620,1,0.32242170789100544,1
4621,9242,-4621,1,0.856399645057354,1
4630,9260,-4630,1,0.9924930772277133,1
4639,9278,-4639,1,0.43306495766894815,1
4642,9284,-4642,1,0.38538668793084374,1
4647,9294,-4647,1,0.6489417973026999,1
4649,9298,-4649,1,0.6893298166606316,1
4657,9314,-4657,1,0.6338658563321115,1
4662,9324,-4662,1,0.10932351208144842,1
4663,9326,-4663,1,0.5901724972606858,1
4664,9328,-4664,1,0.4965080632202501,1
4670,9340,-4670,1,0.48831731895390396,1
4675,9350,-4675,1,0.6349737213886221,1
4678,9356,-4678,1,0.07278216172392626,1
4679,9358,-4679,1,0.1493840846277391,1
4684,9368,-4684,1,0.6645289171352133,1
4689,9378,-4689,1,0.9790618496839433,1
4696,9392,-4696,1,0.9238685023882643,1
4706,9412,-4706,1,0.5543359359021042,1
4708,9416,-4708,1,0.7397157227721104,1
4710,9420,-4710,1,0.22762671998959527,1
4711,9422,-4711,1,0.02479695241622859,1
4714,9428,-4714,1,0.37859497754866045,1
4715,9430,-4715,1,0.11144932669576657,1
4717,9434,-4717,1,0.2796906965531418,1
4719,9438,-4719,1,0.25830143946699424,1
4723,9446,-4723,1,0.19568011376043237,1
4724,9448,-4724,1,0.255977983499865,1
4730,9460,-4730,1,0.7248664995173058,1
4734,9468,-4734,1,0.935269928963702,1
4735,9470,-4735,1,0.5735275580002269,1
4736,9472,-4736,1,0.1413736956151458,1
4737,9474,-4737,1,0.6710055180277604,1
4742,9484,-4742,1,0.8952224519349447,1
4744,9488,-4744,1,0.8424155897811767,1
4745,9490,-4745,1,0.08614959723915883,1
4748,9496,-4748,1,0.2562132965171643,1
4757,9514,-4757,1,0.03846283016241625,1
4764,9528,-4764,1,0.5837806384868972,1
4765,9530,-4765,1,0.9435515602679097,1
4767,9534,-4767,1,0.9718054495656772,1
4770,9540,-4770,1,0.5531248087574633,1
4773,9546,-4773,1,0.7021932293809232,1
4774,9548,-4774,1,0.8833003903104332,1
4775,9550,-4775,1,0.3913577423619876,1
4779,9558,-4779,1,0.28701003363170186,1
4786,9572,-4786,1,0.6006467278231393,1
4787,9574,-4787,1,0.6770028383659038,1
4788,9576,-4788,1,0.005048581898573268,1
4793,9586,-4793,1,0.02674516267734328,1
4795,9590,-4795,1,0.4176373600143316,1
4800,9600,-4800,1,0.42789147594684307,1
4801,9602,-4801,1,0.8943955988598727,1
4802,9604,-4802,1,0.3540131671079839,1
4805,9610,-4805,1,0.5168026625558727,1
4809,9618,-4809,1,0.6161770770180715,1
4810,9620,-4810,1,0.31459274084842437,1
4812,9624,-4812,1,0.24808827980368342,1
4820,9640,-4820,1,0.4417795527227695,1
4821,9642,-4821,1,0.9252141576752184,1
4823,9646,-4823,1,0.1875806419956464,1
4824,9648,-4824,1,0.6200219038494277,1
4825,9650,-4825,1,0.26065893079765123,1
4826,9652,-4826,1,0.8957133701942764,1
4840,9680,-4840,1,0.7899717797941636,1
4846,9692,-4846,1,0.9050703378562335,1
4847,9694,-4847,1,0.7136219260566593,1
4848,9696,-4848,1,0.6752734457651481,1
4852,9704,-4852,1,0.9388643934622689,1
4856,9712,-4856,1,0.013992386716455418,1
4857,9714,-4857,1,0.02286895806453737,1
4862,9724,-4862,1,0.20219648005188184,1
4871,9742,-4871,1,0.9157833145070755,1
4872,9744,-4872,1,0.5662967797237932,1
4890,9780,-4890,1,0.6254453272977731,1
4897,9794,-4897,1,0.6465872720951775,1
4902,9804,-4902,1,0.624899796874516,1
4911,9822,-4911,1,0.9136512734539595,1
4918,9836,-4918,1,0.5964529588061138,1
4921,9842,-4921,1,0.09412360609502823,1
4922,9844,-4922,1,0.8396770257179375,1
4923,9846,-4923,1,0.253852285208943,1
4926,9852,-4926,1,0.19813999124428727,1
4928,9856,-4928,1,0.2848600648897385,1
4935,9870,-4935,1,0.22788259794139076,1
4937,9874,-4937,1,0.8151014424141586,1
4938,9876,-4938,1,0.2823759845060977,1
4939,9878,-4939,1,0.3194616725665693,1
4942,9884,-4942,1,0.21963063907308755,1
4944,9888,-4944,1,0.87609726304312,1
4945,9890,-4945,1,0.9675688810073705,1
4946,9892,-4946,1,0.021614060161583737,1
4947,9894,-4947,1,0.4736270438377622,1
4949,9898,-4949,1,0.7644109554559758,1
4951,9902,-4951,1,0.17177604741461072,1
4952,9904,-4952,1,0.7367272855525223,1
4953,9906,-4953,1,0.7942224921093265,1
4956,9912,-4956,1,0.13014994167018668,1
4957,9914,-4957,1,0.0675002074927975,1
4958,9916,-4958,1,0.9172796307501686,1
4959,9918,-4959,1,0.11392381817235897,1
4963,9926,-4963,1,0.49715294186218006,1
4975,9950,-4975,1,0.9198015919090847,1
4977,9954,-4977,1,0.839712091243171,1
4978,9956,-4978,1,0.9648841028871686,1
4979,9958,-4979,1,0.7245730800282871,1
4984,9968,-4984,1,0.7348666732431975,1
4988,9976,-4988,1,0.18930225380338728,1
4992,9984,-4992,1,0.7301110727679179,1
4996,9992,-4996,1,0.9089031349758679,1
5004,10008,-5004,1,0.6999692455879513,1
5006,10012,-5006,1,0.2976396633699636,1
5007,10014,-5007,1,0.994807420458411,1
5010,10020,-5010,1,0.7671028458932042,1
5014,10028,-5014,1,0.7989564903337606,1
5017,10034,-5017,1,0.013879297045713335,1
5025,10050,-5025,1,0.17872077074000292,1
5026,10052,-5026,1,0.5745597475078995,1
5028,10056,-5028,1,0.21491383836254907,1
5030,10060,-5030,1,0.5495864910717315,1
5031,10062,-5031,1,0.8220417972543248,1
5036,10072,-5036,1,0.08297659140382863,1
5037,10074,-5037,1,0.6783821907105599,1
5041,10082,-5041,1,0.24525635514719957,1
5044,10088,-5044,1,0.9917670894249863,1
5047,10094,-5047,1,0.10364860107246054,1
5051,10102,-5051,1,0.3233937747289084,1
5055,10110,-5055,1,0.26346460310589603,1
5061,10122,-5061,1,0.6438524002212264,1
5063,10126,-5063,1,0.3408227004474832,1
5069,10138,-5069,1,0.018874120430851127,1
5070,10140,-5070,1,0.47034109066593865,1
5073,10146,-5073,1,0.6451367991319853,1
5075,10150,-5075,1,0.5162236532235707,1
5076,10152,-5076,1,0.35166987063464306,1
5080,10160,-5080,1,0.3158537961065463,1
5081,10162,-5081,1,0.7198714097366617,1
5085,10170,-5085,1,0.605659299793243,1
5086,10172,-5086,1,0.5372159780667708,1
5089,10178,-5089,1,0.40135736440609604,1
5091,10182,-5091,1,0.8236939549713148,1
5094,10188,-5094,1,0.0014061934458108327,1
5095,10190,-5095,1,0.8385686925678015,1
5100,10200,-5100,1,0.08081489644700746,1
5103,10206,-5103,1,0.051169356444688674,1
5108,10216,-5108,1,0.803698524889934,1
5110,10220,-5110,1,0.532843194084952,1
5111,10222,-5111,1,0.6293731662710086,1
5114,10228,-5114,1,0.08859748873593876,1
5116,10232,-5116,1,0.588274138919147,1
5120,10240,-5120,1,0.025881698337493875,1
5123,10246,-5123,1,0.8645843602954632,1
5126,10252,-5126,1,0.33320086610915,1
5127,10254,-5127,1,0.13644926274467684,1
5129,10258,-5129,1,0.39796811676730903,1
5131,10262,-5131,1,0.3755890811817567,1
5135,10270,-5135,1,0.08810275294140091,1
5147,10294,-5147,1,0.6823176119894648,1
5149,10298,-5149,1,0.13765014052528757,1
5159,10318,-5159,1,0.4923012254589816,1
5160,10320,-5160,1,0.3449942243558036,1
5161,10322,-5161,1,0.43130897201238294,1
5163,10326,-5163,1,0.9308659966721335,1
5164,10328,-5164,1,0.38210486723993364,1
5169,10338,-5169,1,0.09193432087397435,1
5171,10342,-5171,1,0.046125425673927634,1
5173,10346,-5173,1,0.13411674613121005,1
5174,10348,-5174,1,0.23733311225212372,1
5178,10356,-5178,1,0.6797096535478114,1
5179,10358,-5179,1,0.8550095821457465,1
5188,10376,-5188,1,0.38250596821068816,1
5190,10380,-5190,1,0.05890274552519803,1
5194,10388,-5194,1,0.30785988194158964,1
5198,10396,-5198,1,0.07439574059413023,1
5200,10400,-5200,1,0.2432969494287578,1
5204,10408,-5204,1,0.7587514476451407,1
5205,10410,-5205,1,0.9752626510756287,1
5207,10414,-5207,1,0.7397632134807778,1
5208,10416,-5208,1,0.03228842368224827,1
5209,10418,-5209,1,0.11365096247503836,1
5210,10420,-5210,1,0.27219481740184015,1
5220,10440,-5220,1,0.18797430225244738,1
5221,10442,-5221,1,0.11882012682791765,1
5225,10450,-5225,1,0.5624756067373152,1
5226,10452,-5226,1,0.9903451488625464,1
5229,10458,-5229,1,0.6491721581272101,1
5231,10462,-5231,1,0.788412449598514,1
5235,10470,-5235,1,0.7379152960533879,1
5236,10472,-5236,1,0.30083183302212524,1
5238,10476,-5238,1,0.8153191686520794,1
5245,10490,-5245,1,0.5026469427416261,1
5250,10500,-5250,1,0.9439029292989412,1
5252,10504,-5252,1,0.4971155688849467,1
5254,10508,-5254,1,0.6654217831024427,1
5255,10510,-5255,1,0.8829312035402761,1
5267,10534,-5267,1,0.826664667568599,1
5270,10540,-5270,1,0.9584339720336057,1
5272,10544,-5272,1,0.2633850207224754,1
5273,10546,-5273,1,0.2385374709652508,1
5274,10548,-5274,1,0.3411577785047627,1
5279,10558,-5279,1,0.6582137344519469,1
5287,10574,-5287,1,0.007048417168099119,1
5289,10578,-5289,1,0.7684776037425924,1
5295,10590,-5295,1,0.46131305696134717,1
5297,10594,-5297,1,0.213025827944602,1
5298,10596,-5298,1,0.817281393100761,1
5299,10598,-5299,1,0.4444100867267945,1
5303,10606,-5303,1,0.43911082870848706,1
5305,10610,-5305,1,0.6357618641770966,1
5307,10614,-5307,1,0.19293211655097586,1
5309,10618,-5309,1,0.3281503297769319,1
5313,10626,-5313,1,0.016849067890070235,1
5315,10630,-5315,1,0.1897093941935365,1
5318,10636,-5318,1,0.1532468522140925,1
5322,10644,-5322,1,0.47377572177037897,1
5325,10650,-5325,1,0.2469089148552981,1
5326,10652,-5326,1,0.02599813953334751,1
5331,10662,-5331,1,0.01303482967120162,1
5335,10670,-5335,1,0.7487594960106758,1
5336,10672,-5336,1,0.02297291839422666,1
5338,10676,-5338,1,0.012628034344778105,1
5340,10680,-5340,1,0.10754003442922278,1
5346,10692,-5346,1,0.4865189204467667,1
5347,10694,-5347,1,0.4405185161054678,1
5350,10700,-5350,1,0.001667687420726649,1
5353,10706,-5353,1,0.39157943086769764,1
5355,10710,-5355,1,0.5794919919908823,1
5357,10714,-5357,1,0.587138555896908,1
5358,10716,-5358,1,0.00447761229666499,1
5360,10720,-5360,1,0.023959070294714446,1
5367,10734,-5367,1,0.03114807980876433,1
5368,10736,-5368,1,0.5999678267846879,1
5372,10744,-5372,1,0.8582096930560495,1
5382,10764,-5382,1,0.2895352076178621,1
5385,10770,-5385,1,0.6953347973279025,1
5386,10772,-5386,1,0.7579357779021123,1
5392,10784,-5392,1,0.2216574554085936,1
5395,10790,-5395,1,0.1076625295246817,1
5397,10794,-5397,1,0.004832740853458084,1
5398,10796,-5398,1,0.306464847688355,1
5399,10798,-5399,1,0.7727240214913672,1
5404,10808,-5404,1,0.4213938731333724,1
5405,10810,-5405,1,0.09406761773111727,1
5410,10820,-5410,1,0.3132278227012927,1
5411,10822,-5411,1,0.4661134261343465,1
5412,10824,-5412,1,0.909731638789374,1
5418,10836,-5418,1,0.9756616787855278,1
5423,10846,-5423,1,0.29823654448219283,1
5429,10858,-5429,1,0.41753748363329524,1
5431,10862,-5431,1,0.9043324755834552,1
5432,10864,-5432,1,0.6811890942104061,1
5436,10872,-5436,1,0.2865432608027424,1
5446,10892,-5446,1,0.026276516459465493,1
5449,10898,-5449,1,0.5395732599278699,1
5450,10900,-5450,1,0.7317732981928238,1
5451,10902,-5451,1,0.23102800963583991,1
5452,10904,-5452,1,0.2885191190550148,1
5453,10906,-5453,1,0.8866288376115649,1
5454,10908,-5454,1,0.5862301883121251,1
5461,10922,-5461,1,0.4524820443112816,1
5463,10926,-5463,1,0.20928048226814444,1
5464,10928,-5464,1,0.11854240649325265,1
5470,10940,-5470,1,0.07884823365166838,1
5475,10950,-5475,1,0.6137580142627308,1
5477,10954,-5477,1,0.28776374632044166,1
5478,10956,-5478,1,0.6756017630352797,1
5481,10962,-5481,1,0.6460058044047089,1
5484,10968,-5484,1,0.7854991184715353,1
5486,10972,-5486,1,0.32750804272958334,1
5491,10982,-5491,1,0.5789011306257297,1
5498,10996,-5498,1,0.5346691853519466,1
5502,11004,-5502,1,0.812844579229587,1
5504,11008,-5504,1,0.4056547927963867,1
5505,11010,-5505,1,0.8479352617423833,1
5511,11022,-5511,1,0.1722671674235806,1
5514,11028,-5514,1,0.9926395353688834,1
5515,11030,-5515,1,0.9274726549708557,1
5516,11032,-5516,1,0.28096627681282016,1
5519,11038,-5519,1,0.38819299752629166,1
5525,11050,-5525,1,0.2639195229449002,1
5530,11060,-5530,1,0.8338826445227303,1
5539,11078,-5539,1,0.22934160715471974,1
5542,11084,-5542,1,0.8559307177400265,1
5549,11098,-5549,1,0.019658938059799902,1
5550,11100,-5550,1,0.02013110477017055,1
5551,11102,-5551,1,0.17392933104359753,1
5554,11108,-5554,1,0.9600479899075076,1
5555,11110,-5555,1,0.6505492401433235,1
5557,11114,-5557,1,0.5324612361041264,1
5560,11120,-5560,1,0.6447602008340563,1
5564,11128,-5564,1,0.2509181105450018,1
5573,11146,-5573,1,0.8981829964911874,1
5575,11150,-5575,1,0.4830366652515249,1
5576,11152,-5576,1,0.8781405763037644,1
5577,11154,-5577,1,0.059947731649318214,1
5579,11158,-5579,1,0.32236563539015184,1
5580,11160,-5580,1,0.14100885876546043,1
5581,11162,-5581,1,0.8472475079664222,1
5582,11164,-5582,1,0.792530305439859,1
5587,11174,-5587,1,0.7363120983159955,1
5589,11178,-5589,1,0.10335939209275202,1
5591,11182,-5591,1,0.9383998225499842,1
5592,11184,-5592,1,0.9056315100919401,1
5595,11190,-5595,1,0.9317571214697333,1
5599,11198,-5599,1,0.5210354972001806,1
5607,11214,-5607,1,0.48552704733756535,1
5608,11216,-5608,1,0.3028609118850326,1
5609,11218,-5609,1,0.9151211230583124,1
5611,11222,-5611,1,0.14499555488851423,1
5619,11238,-5619,1,0.7758614979050767,1
5620,11240,-5620,1,0.8620521649823149,1
5621,11242,-5621,1,0.5119872058696998,1
5623,11246,-5623,1,0.33003696412662376,1
5625,11250,-5625,1,0.4092597271112913,1
5629,11258,-5629,1,0.49807878833211106,1
5630,11260,-5630,1,0.5601215294186417,1
5631,11262,-5631,1,0.9912151756765157,1
5633,11266,-5633,1,0.8362473114339626,1
5634,11268,-5634,1,0.9360789875413686,1
5635,11270,-5635,1,0.1763287778685405,1
5636,11272,-5636,1,0.2734186863491922,1
5650,11300,-5650,1,0.06727884068735623,1
5653,11306,-5653,1,0.11477337870377236,1
5656,11312,-5656,1,0.7021463232706964,1
5657,11314,-5657,1,0.7292265573599327,1
5658,11316,-5658,1,0.3228632831613628,1
5659,11318,-5659,1,0.5921415175899784,1
5662,11324,-5662,1,0.059860257701376485,1
5671,11342,-5671,1,0.46076563699650475,1
5689,11378,-5689,1,0.6842047167318824,1
5694,11388,-5694,1,0.05694648860299878,1
5695,11390,-5695,1,0.43840299449771947,1
5696,11392,-5696,1,0.39177037065414255,1
5700,11400,-5700,1,0.4582472780088387,1
5702,11404,-5702,1,0.5757715610607937,1
5707,11414,-5707,1,0.8656035583009374,1
5712,11424,-5712,1,0.445161213492282,1
5713,11426,-5713,1,0.6347553077253678,1
5715,11430,-5715,1,0.7970295720457017,1
5718,11436,-5718,1,0.909382401983351,1
5720,11440,-5720,1,0.016179526375709297,1
5726,11452,-5726,1,0.41605753507450316,1
5728,11456,-5728,1,0.0020639823456974904,1
5729,11458,-5729,1,0.2311074527343615,1
5731,11462,-5731,1,0.4540625382710335,1
5732,11464,-5732,1,0.17842916718949953,1
5733,11466,-5733,1,0.9362286958811925,1
5735,11470,-5735,1,0.28281257653701575,1
5736,11472,-5736,1,0.6106355388658138,1
5744,11488,-5744,1,0.8236446588323737,1
5746,11492,-5746,1,0.36169879843204955,1
5749,11498,-5749,1,0.48891339269839207,1
5750,11500,-5750,1,0.8081438457504982,1
5755,11510,-5755,1,0.36879318641424097,1
5756,11512,-5756,1,0.9126154953175701,1
5760,11520,-5760,1,0.26267308378888043,1
5761,11522,-5761,1,0.46935750973513146,1
5762,11524,-5762,1,0.15521929083752783,1
5768,11536,-5768,1,0.13705803782497294,1
5769,11538,-5769,1,0.48159344034191476,1
5777,11554,-5777,1,0.374195596626239,1
5778,11556,-5778,1,0.5829164874384221,1
5785,11570,-5785,1,0.3505663191173273,1
5788,11576,-5788,1,0.03218389203031058,1
5790,11580,-5790,1,0.7579883148919268,1
5791,11582,-5791,1,0.7623488442841595,1
5793,11586,-5793,1,0.5804806545905599,1
5798,11596,-5798,1,0.40416701342473393,1
5802,11604,-5802,1,0.4137988329347756,1
5811,11622,-5811,1,0.0371566880865597,1
5814,11628,-5814,1,0.8893573609783885,1
5816,11632,-5816,1,0.9414618104731506,1
5820,11640,-5820,1,0.668812967495483,1
5822,11644,-5822,1,0.9357554404735654,1
5826,11652,-5826,1,0.8157479515339099,1
5827,11654,-5827,1,0.639509235337361,1
5828,11656,-5828,1,0.4881134949175583,1
5832,11664,-5832,1,0.04888127591368285,1
5836,11672,-5836,1,0.06259594455914952,1
5838,11676,-5838,1,0.7186915080680919,1
5839,11678,-5839,1,0.8455283104958583,1
5840,11680,-5840,1,0.8777604299967304,1
5843,11686,-5843,1,0.8982180260611384,1
5846,11692,-5846,1,0.26656189549719733,1
5848,11696,-5848,1,0.68028766334177,1
5854,11708,-5854,1,0.3854582720095784,1
5860,11720,-5860,1,0.40372761519901246,1
5861,11722,-5861,1,0.3551765145225858,1
5867,11734,-5867,1,0.7565542081986008,1
5870,11740,-5870,1,0.8044631871145536,1
5872,11744,-5872,1,0.9275872125412374,1
5873,11746,-5873,1,0.037560917765724455,1
5874,11748,-5874,1,0.6407551734028549,1
5877,11754,-5877,1,0.6858651508025453,1
5882,11764,-5882,1,0.8529954812334077,1
5883,11766,-5883,1,0.9409213567533303,1
5884,11768,-5884,1,0.42683737295378665,1
5888,11776,-5888,1,0.16838595293946979,1
5891,11782,-5891,1,0.9213187149283439,1
5893,11786,-5893,1,0.5515168135395084,1
5895,11790,-5895,1,0.8686667326585383,1
5896,11792,-5896,1,0.1417664170048616,1
5900,11800,-5900,1,0.955581564055389,1
5902,11804,-5902,1,0.6940915303241169,1
5909,11818,-5909,1,0.4262582076352118,1
5910,11820,-5910,1,0.3979596762279378,1
5915,11830,-5915,1,0.35861034383297996,1
5918,11836,-5918,1,0.935522177175038,1
5921,11842,-5921,1,0.9744595737100248,1
5927,11854,-5927,1,0.8562949043909633,1
5930,11860,-5930,1,0.7588668662068185,1
5931,11862,-5931,1,0.3472882828537651,1
5934,11868,-5934,1,0.2254654574965157,1
5938,11876,-5938,1,0.39251302071401073,1
5939,11878,-5939,1,0.6328201455445398,1
5944,11888,-5944,1,0.1399812091680558,1
5945,11890,-5945,1,0.7235528824037636,1
5948,11896,-5948,1,0.8676383029636044,1
5958,11916,-5958,1,0.12570654706958684,1
5959,11918,-5959,1,0.6961341557650766,1
5960,11920,-5960,1,0.21226994150459344,1
5961,11922,-5961,1,0.3232024174665665,1
5968,11936,-5968,1,0.8533610162051357,1
5974,11948,-5974,1,0.9211740064214324,1
5975,11950,-5975,1,0.8103852020080881,1
5994,11988,-5994,1,0.04003062516027733,1
5998,11996,-5998,1,0.08054151271021326,1
5999,11998,-5999,1,0.9593095762522259,1
