0,0,0,1,0.04253141743673128,0
1,2,-1,1,0.32538415828097944,0
2,4,-2,1,0.3003484232762734,0
3,6,-3,1,0.504134134769817,0
4,8,-4,1,0.553187202231055,0
5,10,-5,1,0.7673933187712387,0
7,14,-7,1,0.5116465164047181,0
8,16,-8,1,0.3301511757285256,0
11,22,-11,1,0.9045793338381617,0
12,24,-12,1,0.8674393606581621,0
13,26,-13,1,0.8451908920575806,0
14,28,-14,1,0.5861591939876913,0
15,30,-15,1,0.3718993423769993,0
17,34,-17,1,0.42347988290399785,0
19,38,-19,1,0.41909064849533917,0
20,40,-20,1,0.0763825252595407,0
21,42,-21,1,0.8415379584208252,0
22,44,-22,1,0.6081650035508207,0
24,48,-24,1,0.06635380353008291,0
25,50,-25,1,0.525457778689376,0
28,56,-28,1,0.3309420070433696,0
29,58,-29,1,0.22834427737319207,0
30,60,-30,1,0.6492837223657244,0
31,62,-31,1,0.32899607009585663,0
35,70,-35,1,0.42979747719664085,0
36,72,-36,1,0.14499912267429738,0
38,76,-38,1,0.885045537342232,0
40,80,-40,1,0.24306938921138832,0
42,84,-42,1,0.7613467979301202,0
46,92,-46,1,0.5447188607762099,0
48,96,-48,1,0.1143841608536853,0
49,98,-49,1,0.3051188561765591,0
50,100,-50,1,0.2153013619838101,0
51,102,-51,1,0.20872113263969394,0
52,104,-52,1,0.6446888187320116,0
57,114,-57,1,0.34332959665894847,0
58,116,-58,1,0.12162142392332465,0
59,118,-59,1,0.2527525130770951,0
60,120,-60,1,0.7060879884548209,0
61,122,-61,1,0.585536125527287,0
62,124,-62,1,0.6975405030090474,0
63,126,-63,1,0.03916579899578054,0
65,130,-65,1,0.6590649244407948,0
66,132,-66,1,0.10574408553895165,0
67,134,-67,1,0.7674031782913672,0
68,136,-68,1,0.13013099594985622,0
69,138,-69,1,0.15189921941288465,0
70,140,-70,1,0.006198172309947569,0
72,144,-72,1,0.6152250524279421,0
74,148,-74,1,0.46459783314330894,0
77,154,-77,1,0.7125937747268171,0
78,156,-78,1,0.5380490236564093,0
79,158,-79,1,0.8292362332872567,0
80,160,-80,1,0.1353237442863099,0
83,166,-83,1,0.1698920277245568,0
86,172,-86,1,0.2131467920127762,0
87,174,-87,1,0.10338719989256728,0
88,176,-88,1,0.765186019168476,0
93,186,-93,1,0.7305745598918372,0
94,188,-94,1,0.04822869935994878,0
95,190,-95,1,0.5156504629981901,0
96,192,-96,1,0.644892941232298,0
97,194,-97,1,0.8837951543403101,0
98,196,-98,1,0.8403147064237666,0
99,198,-99,1,0.3123344279534743,0
100,200,-100,1,0.9130138448684092,0
101,202,-101,1,0.4959962594995371,0
103,206,-103,1,0.6620046551738495,0
104,208,-104,1,0.23774098020740675,0
106,212,-106,1,0.8240588280813516,0
107,214,-107,1,0.26657964957029867,0
108,216,-108,1,0.7899934847804431,0
111,222,-111,1,0.8610522984711166,0
113,226,-113,1,0.7274036372069608,0
114,228,-114,1,0.6316716605883991,0
115,230,-115,1,0.5623386140267007,0
119,238,-119,1,0.3676758934828813,0
125,250,-125,1,0.13260803699257562,0
126,252,-126,1,0.2871827964110958,0
127,254,-127,1,0.22837010943881997,0
129,258,-129,1,0.5287353565991958,0
130,260,-130,1,0.6193927769696854,0
131,262,-131,1,0.9060983451696112,0
132,264,-132,1,0.5939436480218667,0
133,266,-133,1,0.45845922502222003,0
135,270,-135,1,0.036063691604216186,0
139,278,-139,1,0.39571083386425954,0
141,282,-141,1,0.1453939418108957,0
142,284,-142,1,0.21134859546976215,0
143,286,-143,1,0.5343400025781694,0
144,288,-144,1,0.10184554742809193,0
146,292,-146,1,0.48922503758555214,0
147,294,-147,1,0.328248485828314,0
148,296,-148,1,0.4764652276775453,0
149,298,-149,1,0.8350515990766157,0
152,304,-152,1,0.9437754139163697,0
154,308,-154,1,0.4130948663716829,0
155,310,-155,1,0.8509139039302936,0
156,312,-156,1,0.9003734678048068,0
157,314,-157,1,0.47089580759120975,0
159,318,-159,1,0.911021440689653,0
160,320,-160,1,0.18092402093746496,0
161,322,-161,1,0.7611771144767755,0
162,324,-162,1,0.08194567855894574,0
164,328,-164,1,0.7153002917150666,0
165,330,-165,1,0.5643812779310395,0
167,334,-167,1,0.6610340642627117,0
169,338,-169,1,0.6486604323215764,0
170,340,-170,1,0.5227169280860816,0
171,342,-171,1,0.17183227147106006,0
172,344,-172,1,0.7189434017341731,0
173,346,-173,1,0.00976929494953116,0
174,348,-174,1,0.8855974319946922,0
175,350,-175,1,0.35499098368198856,0
177,354,-177,1,0.6357382128302931,0
178,356,-178,1,0.6846931518725976,0
179,358,-179,1,0.2596358110139583,0
180,360,-180,1,0.29454201235118316,0
182,364,-182,1,0.14046993815854758,0
183,366,-183,1,0.6317980499155735,0
184,368,-184,1,0.537155205529653,0
185,370,-185,1,0.849386501422723,0
187,374,-187,1,0.11027481086157442,0
189,378,-189,1,0.337331616235503,0
190,380,-190,1,0.7149395045973376,0
191,382,-191,1,0.6824160829909871,0
192,384,-192,1,0.626996167595534,0
196,392,-196,1,0.19458411638692552,0
197,394,-197,1,0.6551511099516584,0
198,396,-198,1,0.9940019971819608,0
199,398,-199,1,0.12606155444505285,0
200,400,-200,1,0.7245223887708938,0
201,402,-201,1,0.7496111996028194,0
203,406,-203,1,0.10436453266210355,0
204,408,-204,1,0.9675399930081315,0
205,410,-205,1,0.27021890913985214,0
208,416,-208,1,0.7152849898899999,0
209,418,-209,1,0.9366179473103065,0
210,420,-210,1,0.6183387403801321,0
211,422,-211,1,0.7711783923531194,0
213,426,-213,1,0.493967969729769,0
216,432,-216,1,0.06785152012729179,0
217,434,-217,1,0.026206291606470367,0
218,436,-218,1,0.7772450035167511,0
220,440,-220,1,0.2189690894350137,0
221,442,-221,1,0.5173426517731274,0
223,446,-223,1,0.9282163642499581,0
224,448,-224,1,0.516556762970493,0
225,450,-225,1,0.14422466674506307,0
226,452,-226,1,0.6783781656924825,0
227,454,-227,1,0.7242513798661596,0
228,456,-228,1,0.16670836990459104,0
229,458,-229,1,0.9931894351293624,0
231,462,-231,1,0.5542563939932932,0
233,466,-233,1,0.9778532128141563,0
235,470,-235,1,0.4494644773725518,0
238,476,-238,1,0.3758357730763897,0
240,480,-240,1,0.3224665634424516,0
241,482,-241,1,0.36665541426174375,0
243,486,-243,1,0.06479520005974759,0
244,488,-244,1,0.24873893065367003,0
245,490,-245,1,0.8231456502072797,0
246,492,-246,1,0.5923256558970305,0
247,494,-247,1,0.16955311661776595,0
248,496,-248,1,0.07879782881650732,0
250,500,-250,1,0.860434543828787,0
252,504,-252,1,0.5681752829557634,0
255,510,-255,1,0.18692059897808755,0
256,512,-256,1,0.9628494042147889,0
259,518,-259,1,0.9937379974229891,0
260,520,-260,1,0.9796418805733746,0
262,524,-262,1,0.5755631248342395,0
263,526,-263,1,0.7803548400714745,0
264,528,-264,1,0.3084029370271377,0
265,530,-265,1,0.8308794578444642,0
266,532,-266,1,0.2938164852047238,0
267,534,-267,1,0.8872893383262082,0
268,536,-268,1,0.5972666297551085,0
269,538,-269,1,0.5942655610906195,0
270,540,-270,1,0.5968551616674806,0
271,542,-271,1,0.7038586557730926,0
272,544,-272,1,0.08955295331412538,0
276,552,-276,1,0.8532215748207335,0
277,554,-277,1,0.48900886886431894,0
278,556,-278,1,0.30071623420074334,0
279,558,-279,1,0.08954431655372208,0
281,562,-281,1,0.651687288125142,0
282,564,-282,1,0.4995832836748557,0
283,566,-283,1,0.8846460317544281,0
284,568,-284,1,0.31166049595221323,0
286,572,-286,1,0.30505896423119205,0
287,574,-287,1,0.38229796265935867,0
288,576,-288,1,0.6358219523103499,0
289,578,-289,1,0.9386131589493284,0
290,580,-290,1,0.4146286424943083,0
291,582,-291,1,0.6537869349976918,0
293,586,-293,1,0.23024279879516052,0
294,588,-294,1,0.9976150104347197,0
296,592,-296,1,0.28918192673467924,0
297,594,-297,1,0.26825576325898703,0
298,596,-298,1,0.5690159360332169,0
301,602,-301,1,0.8953446655133147,0
302,604,-302,1,0.4603852481404628,0
303,606,-303,1,0.22160019045955093,0
304,608,-304,1,0.63652117919826,0
305,610,-305,1,0.13445031003277863,0
307,614,-307,1,0.3575755198913979,0
308,616,-308,1,0.7690017390854489,0
309,618,-309,1,0.17688480413825036,0
310,620,-310,1,0.8567361486527332,0
311,622,-311,1,0.648196749149802,0
312,624,-312,1,0.6412652663065623,0
313,626,-313,1,0.5281946106465593,0
314,628,-314,1,0.882860149781239,0
318,636,-318,1,0.7657572097807958,0
319,638,-319,1,0.6611312416200334,0
320,640,-320,1,0.7935187914535946,0
321,642,-321,1,0.6012510913126243,0
324,648,-324,1,0.6562284105475589,0
325,650,-325,1,0.448587830050696,0
327,654,-327,1,0.5449754123418019,0
328,656,-328,1,0.4760976267853092,0
329,658,-329,1,0.31949877178667185,0
330,660,-330,1,0.23096807630914096,0
332,664,-332,1,0.044145187565379995,0
336,672,-336,1,0.8272539180403383,0
337,674,-337,1,0.80026332690589,0
340,680,-340,1,0.8591071229546328,0
341,682,-341,1,0.2404820935150832,0
342,684,-342,1,0.30172125410357953,0
344,688,-344,1,0.09439890915304738,0
347,694,-347,1,0.7206582012188105,0
349,698,-349,1,0.9231850148104781,0
351,702,-351,1,0.01111802897797698,0
354,708,-354,1,0.6254626065631942,0
356,712,-356,1,0.9102012264266488,0
358,716,-358,1,0.5992268720352127,0
359,718,-359,1,0.01250306747346741,0
361,722,-361,1,0.013098055721454283,0
362,724,-362,1,0.01306096506038823,0
363,726,-363,1,0.8159716088240033,0
364,728,-364,1,0.08213185926568833,0
367,734,-367,1,0.3019196354347131,0
368,736,-368,1,0.11083823127904768,0
369,738,-369,1,0.3278481168908455,0
370,740,-370,1,0.038526660907344246,0
371,742,-371,1,0.4684142169944313,0
374,748,-374,1,0.3668817932406371,0
375,750,-375,1,0.39251192568748416,0
376,752,-376,1,0.2415596680258929,0
377,754,-377,1,0.25322761732253307,0
379,758,-379,1,0.9769749851368736,0
380,760,-380,1,0.558526227470826,0
382,764,-382,1,0.9578705467773694,0
384,768,-384,1,0.2961678529906713,0
385,770,-385,1,0.40457770171764196,0
386,772,-386,1,0.8129175927934362,0
387,774,-387,1,0.9961433473967223,0
389,778,-389,1,0.36367656075726784,0
391,782,-391,1,0.8817241583629293,0
392,784,-392,1,0.7557830200393154,0
393,786,-393,1,0.6905326435693339,0
395,790,-395,1,0.2679280013171552,0
396,792,-396,1,0.8629747774302492,0
398,796,-398,1,0.9810024218887136,0
399,798,-399,1,0.9829282556619897,0
400,800,-400,1,0.6528779575018007,0
401,802,-401,1,0.6355003363540384,0
402,804,-402,1,0.5660126197233832,0
403,806,-403,1,0.31588163645109246,0
404,808,-404,1,0.9791514841492298,0
405,810,-405,1,0.8120238894261548,0
406,812,-406,1,0.3751982804969972,0
409,818,-409,1,0.6980808203824985,0
410,820,-410,1,0.9977489653297681,0
411,822,-411,1,0.3932216799568835,0
412,824,-412,1,0.17244327226507794,0
413,826,-413,1,0.7921336876654878,0
414,828,-414,1,0.010391954733622533,0
415,830,-415,1,0.6296810329422816,0
416,832,-416,1,0.49193066701875443,0
424,848,-424,1,0.921761446767978,0
425,850,-425,1,0.5614368115741419,0
426,852,-426,1,0.1581324204451029,0
430,860,-430,1,0.30206408167336696,0
431,862,-431,1,0.057404934544104225,0
433,866,-433,1,0.7195821244644597,0
435,870,-435,1,0.3466776718037584,0
436,872,-436,1,0.8856686145365347,0
437,874,-437,1,0.45757272178710606,0
438,876,-438,1,0.9484937200967948,0
439,878,-439,1,0.31478414692576007,0
440,880,-440,1,0.528107960035205,0
442,884,-442,1,0.23931316685448967,0
443,886,-443,1,0.9519289234491493,0
446,892,-446,1,0.6812401878960784,0
448,896,-448,1,0.31719333747222556,0
449,898,-449,1,0.29032924460862863,0
451,902,-451,1,0.08637559007221984,0
453,906,-453,1,0.38933793482023105,0
454,908,-454,1,0.6159335063763608,0
455,910,-455,1,0.6012289544381636,0
458,916,-458,1,0.23069068364508338,0
459,918,-459,1,0.6079401786354786,0
460,920,-460,1,0.732080455096943,0
465,930,-465,1,0.4590668986212917,0
466,932,-466,1,0.7411000336055853,0
467,934,-467,1,0.23962412693065072,0
470,940,-470,1,0.38281870981342825,0
471,942,-471,1,0.5508000199400154,0
476,952,-476,1,0.36338226509281146,0
477,954,-477,1,0.22929096786852732,0
478,956,-478,1,0.12211663422377439,0
481,962,-481,1,0.49276560460518404,0
482,964,-482,1,0.5193513548134937,0
483,966,-483,1,0.39048391973023555,0
486,972,-486,1,0.04767508519408381,0
487,974,-487,1,0.4240772318407974,0
488,976,-488,1,0.7516050808091229,0
489,978,-489,1,0.5809582318071752,0
490,980,-490,1,0.9182829893065044,0
491,982,-491,1,0.4545778868253778,0
492,984,-492,1,0.3750890662876941,0
493,986,-493,1,0.13238081305753135,0
497,994,-497,1,0.6004662035849714,0
498,996,-498,1,0.39728138895266174,0
499,998,-499,1,0.4564575949153029,0
500,1000,-500,1,0.3706792011024894,0
501,1002,-501,1,0.4699287678184696,0
503,1006,-503,1,0.19206893427787286,0
504,1008,-504,1,0.3605084570312965,0
507,1014,-507,1,0.656133801025897,0
508,1016,-508,1,0.15548894589130802,0
509,1018,-509,1,0.5091914117972683,0
511,1022,-511,1,0.013010487425298423,0
513,1026,-513,1,0.1165655549149851,0
518,1036,-518,1,0.015078753985248827,0
519,1038,-519,1,0.45020094101302877,0
520,1040,-520,1,0.8138035723929706,0
521,1042,-521,1,0.8862514536377246,0
523,1046,-523,1,0.5470893401862311,0
525,1050,-525,1,0.9699661394770758,0
527,1054,-527,1,0.9177587020491131,0
528,1056,-528,1,0.2981900171276092,0
535,1070,-535,1,0.6813931122903675,0
536,1072,-536,1,0.040317402515467116,0
537,1074,-537,1,0.18839995891125894,0
538,1076,-538,1,0.3065579310887998,0
539,1078,-539,1,0.6871013565108663,0
541,1082,-541,1,0.16511939134627052,0
542,1084,-542,1,0.4084452255209289,0
543,1086,-543,1,0.16516189383531288,0
544,1088,-544,1,0.09530069921966522,0
548,1096,-548,1,0.4176446690386407,0
550,1100,-550,1,0.13208596933970118,0
551,1102,-551,1,0.11602272908604594,0
552,1104,-552,1,0.6223233186800851,0
554,1108,-554,1,0.9679086586290633,0
556,1112,-556,1,0.9475811349110849,0
557,1114,-557,1,0.691429444193839,0
558,1116,-558,1,0.4702766275788348,0
559,1118,-559,1,0.6798016985975893,0
560,1120,-560,1,0.4298142532224487,0
561,1122,-561,1,0.40130111865785867,0
562,1124,-562,1,0.9096255942957067,0
563,1126,-563,1,0.3346653575982702,0
566,1132,-566,1,0.5453161285006973,0
567,1134,-567,1,0.11408479197394761,0
568,1136,-568,1,0.48213172353851075,0
571,1142,-571,1,0.15206904293689605,0
572,1144,-572,1,0.10995103433524211,0
573,1146,-573,1,0.9971806077307382,0
574,1148,-574,1,0.17022319677000153,0
575,1150,-575,1,0.581219120965952,0
576,1152,-576,1,0.4448099103455001,0
577,1154,-577,1,0.7149805461005005,0
579,1158,-579,1,0.47371289797002136,0
581,1162,-581,1,0.6065174177934023,0
582,1164,-582,1,0.9616333809871659,0
583,1166,-583,1,0.9505347091090769,0
584,1168,-584,1,0.49080548188284223,0
585,1170,-585,1,0.7079083515846963,0
587,1174,-587,1,0.8942049855981657,0
588,1176,-588,1,0.8398602970629246,0
589,1178,-589,1,0.07676478362129713,0
590,1180,-590,1,0.2684239504721564,0
591,1182,-591,1,0.9306515744218216,0
592,1184,-592,1,0.01616562970026658,0
593,1186,-593,1,0.4834751929774306,0
596,1192,-596,1,0.3253069131347953,0
597,1194,-597,1,0.14490499958955738,0
598,1196,-598,1,0.34328327131963654,0
599,1198,-599,1,0.10693608856433534,0
601,1202,-601,1,0.22320932470388033,0
602,1204,-602,1,0.6112398333204554,0
603,1206,-603,1,0.5330038300406463,0
605,1210,-605,1,0.23859364641604275,0
606,1212,-606,1,0.7410205178117153,0
607,1214,-607,1,0.6712085726028789,0
608,1216,-608,1,0.544639090697961,0
610,1220,-610,1,0.7840357417364966,0
611,1222,-611,1,0.2617548090205234,0
612,1224,-612,1,0.7021899842942947,0
615,1230,-615,1,0.8449243881623096,0
617,1234,-617,1,0.40931136632371556,0
618,1236,-618,1,0.1923693171769988,0
619,1238,-619,1,0.29904956931151006,0
620,1240,-620,1,0.8958448808741739,0
621,1242,-621,1,0.5800955694375195,0
624,1248,-624,1,0.6157668789562261,0
628,1256,-628,1,0.07651774713886528,0
629,1258,-629,1,0.3506057877539309,0
630,1260,-630,1,0.7370443838910815,0
631,1262,-631,1,0.3448583630157779,0
633,1266,-633,1,0.28176848685379785,0
634,1268,-634,1,0.12666667661972464,0
635,1270,-635,1,0.9962221711054551,0
636,1272,-636,1,0.6711067696748666,0
637,1274,-637,1,0.009036480308655781,0
640,1280,-640,1,0.9020932322335873,0
642,1284,-642,1,0.04029133661300155,0
643,1286,-643,1,0.19529412612621233,0
644,1288,-644,1,0.7207617210999975,0
647,1294,-647,1,0.47332945506047497,0
648,1296,-648,1,0.46694812850621015,0
649,1298,-649,1,0.5846008461557519,0
652,1304,-652,1,0.635520098051465,0
653,1306,-653,1,0.8116676270449132,0
654,1308,-654,1,0.5379795511686466,0
657,1314,-657,1,0.9141320427032004,0
658,1316,-658,1,0.11491014863383298,0
660,1320,-660,1,0.07916634760648922,0
661,1322,-661,1,0.8439882512781554,0
662,1324,-662,1,0.7508659781768712,0
663,1326,-663,1,0.5231329185631336,0
665,1330,-665,1,0.12125727530892094,0
667,1334,-667,1,0.5186162215623511,0
669,1338,-669,1,0.44027073382292525,0
670,1340,-670,1,0.900777432012875,0
672,1344,-672,1,0.8773919651978597,0
674,1348,-674,1,0.02373905969889145,0
675,1350,-675,1,0.9377170872716621,0
676,1352,-676,1,0.9224240479121216,0
680,1360,-680,1,0.7656647673202631,0
681,1362,-681,1,0.10305104389903863,0
682,1364,-682,1,0.10017851683297296,0
683,1366,-683,1,0.5630022278341414,0
684,1368,-684,1,0.41337746633348815,0
685,1370,-685,1,0.6648889969145387,0
689,1378,-689,1,0.414340575956784,0
690,1380,-690,1,0.8932664290674053,0
691,1382,-691,1,0.011933532170084526,0
695,1390,-695,1,0.10408115689751296,0
696,1392,-696,1,0.9456877741245033,0
699,1398,-699,1,0.3595668731794345,0
700,1400,-700,1,0.4468335209245562,0
701,1402,-701,1,0.3503770726068508,0
703,1406,-703,1,0.25739138239757253,0
705,1410,-705,1,0.9140026623598506,0
706,1412,-706,1,0.11848953656757966,0
707,1414,-707,1,0.8879724430876469,0
708,1416,-708,1,0.9010017670137462,0
709,1418,-709,1,0.7036480574004517,0
710,1420,-710,1,0.2807457524763052,0
711,1422,-711,1,0.38034261678417813,0
714,1428,-714,1,0.24552543671381366,0
715,1430,-715,1,0.7918382955186029,0
716,1432,-716,1,0.9105046308357253,0
717,1434,-717,1,0.2972760582319931,0
718,1436,-718,1,0.9826580700759362,0
723,1446,-723,1,0.5255444847841011,0
724,1448,-724,1,0.6927614158028731,0
725,1450,-725,1,0.1766495993123255,0
726,1452,-726,1,0.26956430378725627,0
727,1454,-727,1,0.3366305772664696,0
729,1458,-729,1,0.6317183494232868,0
731,1462,-731,1,0.41959424781566834,0
732,1464,-732,1,0.8462166707334988,0
734,1468,-734,1,0.11543089211833202,0
736,1472,-736,1,0.7671632183407123,0
737,1474,-737,1,0.8166242945151246,0
739,1478,-739,1,0.9881657739072343,0
741,1482,-741,1,0.07225369660989323,0
742,1484,-742,1,0.5051538463338647,0
744,1488,-744,1,0.19579386990016878,0
745,1490,-745,1,0.8824765123932798,0
746,1492,-746,1,0.12794825648186314,0
747,1494,-747,1,0.7568418509527908,0
748,1496,-748,1,0.2224113309860617,0
751,1502,-751,1,0.1960145375337894,0
754,1508,-754,1,0.3261006871013207,0
755,1510,-755,1,0.19785765945148237,0
756,1512,-756,1,0.059713041836946146,0
757,1514,-757,1,0.03852711478394477,0
760,1520,-760,1,0.15383266526458939,0
762,1524,-762,1,0.8315713079285992,0
765,1530,-765,1,0.9751438178967123,0
766,1532,-766,1,0.5281510530451877,0
767,1534,-767,1,0.6533451881839761,0
769,1538,-769,1,0.5681120287306498,0
770,1540,-770,1,0.46337273044401184,0
771,1542,-771,1,0.9507238548219838,0
773,1546,-773,1,0.35962242458869675,0
774,1548,-774,1,0.9332702576279672,0
775,1550,-775,1,0.99005330015037,0
776,1552,-776,1,0.8589394587780915,0
777,1554,-777,1,0.3095437554564162,0
778,1556,-778,1,0.046801188642271785,0
779,1558,-779,1,0.1316537451661921,0
782,1564,-782,1,0.9015426097410416,0
783,1566,-783,1,0.9773663239837598,0
784,1568,-784,1,0.08272298408008227,0
785,1570,-785,1,0.03321875921757833,0
786,1572,-786,1,0.7044265580800739,0
787,1574,-787,1,0.10054987367070134,0
788,1576,-788,1,0.7324228943651312,0
789,1578,-789,1,0.49521344020145097,0
790,1580,-790,1,0.851194895364375,0
791,1582,-791,1,0.7632340698664829,0
793,1586,-793,1,0.6166634593249061,0
794,1588,-794,1,0.5658382227565404,0
795,1590,-795,1,0.3228837035161797,0
796,1592,-796,1,0.2908688322489782,0
797,1594,-797,1,0.14270600886186302,0
798,1596,-798,1,0.039914145948253155,0
799,1598,-799,1,0.6701540265022577,0
800,1600,-800,1,0.8006907608516742,0
801,1602,-801,1,0.859486735045103,0
802,1604,-802,1,0.777092501323452,0
803,1606,-803,1,0.9332719541205169,0
804,1608,-804,1,0.5033176622477511,0
805,1610,-805,1,0.6845528003171185,0
808,1616,-808,1,0.7059241383754493,0
809,1618,-809,1,0.13880508338211606,0
811,1622,-811,1,0.3660833946741371,0
813,1626,-813,1,0.04064324021141663,0
814,1628,-814,1,0.8066809356922395,0
815,1630,-815,1,0.39188054044807796,0
816,1632,-816,1,0.3653805504661405,0
818,1636,-818,1,0.2047446884850629,0
819,1638,-819,1,0.9307917865851721,0
822,1644,-822,1,0.2831267103024897,0
824,1648,-824,1,0.6868313267535407,0
829,1658,-829,1,0.3582148693434736,0
830,1660,-830,1,0.8924868956045549,0
832,1664,-832,1,0.2306805228819827,0
834,1668,-834,1,0.179139381756369,0
835,1670,-835,1,0.12554480944467294,0
841,1682,-841,1,0.2508988502155509,0
842,1684,-842,1,0.38355804616094125,0
843,1686,-843,1,0.5155831352438953,0
844,1688,-844,1,0.302475507902656,0
845,1690,-845,1,0.26484622371288835,0
846,1692,-846,1,0.7676096908017243,0
847,1694,-847,1,0.5504578142179795,0
851,1702,-851,1,0.7928681417672906,0
855,1710,-855,1,0.6178106117764436,0
856,1712,-856,1,0.10041712390557644,0
857,1714,-857,1,0.2874853504618974,0
859,1718,-859,1,0.4419185733578985,0
860,1720,-860,1,0.42985657684342604,0
862,1724,-862,1,0.3723680878277742,0
864,1728,-864,1,0.43182584249271627,0
866,1732,-866,1,0.520120072931422,0
867,1734,-867,1,0.7031188937461043,0
868,1736,-868,1,0.8759728759717496,0
869,1738,-869,1,0.8505597322219617,0
870,1740,-870,1,0.016616733920192472,0
871,1742,-871,1,0.04900590483540157,0
872,1744,-872,1,0.07183612642897386,0
873,1746,-873,1,0.37154704996218146,0
874,1748,-874,1,0.9769252100673061,0
875,1750,-875,1,0.27349092846853196,0
876,1752,-876,1,0.5257873419538712,0
877,1754,-877,1,0.6527853314657991,0
879,1758,-879,1,0.048656713719692934,0
883,1766,-883,1,0.6525324715458979,0
885,1770,-885,1,0.9495685524522283,0
886,1772,-886,1,0.43589002763295015,0
888,1776,-888,1,0.8983146320010152,0
889,1778,-889,1,0.7272904864503363,0
890,1780,-890,1,0.25806769035633503,0
891,1782,-891,1,0.5165609270467942,0
892,1784,-892,1,0.4442262599241077,0
893,1786,-893,1,0.5327168470766639,0
894,1788,-894,1,0.8407719039843151,0
895,1790,-895,1,0.4175837701372058,0
896,1792,-896,1,0.5861783861755845,0
898,1796,-898,1,0.23519020353035414,0
900,1800,-900,1,0.6628040332254533,0
901,1802,-901,1,0.8973863511774761,0
902,1804,-902,1,0.5462823980108603,0
903,1806,-903,1,0.374255115681532,0
907,1814,-907,1,0.4266146502377032,0
909,1818,-909,1,0.041256897940246895,0
910,1820,-910,1,0.09930480769229177,0
911,1822,-911,1,0.29017264251971586,0
913,1826,-913,1,0.13297955989985133,0
914,1828,-914,1,0.7782387914504462,0
916,1832,-916,1,0.2384136792968633,0
917,1834,-917,1,0.05235044529393984,0
920,1840,-920,1,0.08895510219171676,0
922,1844,-922,1,0.8554227636345254,0
923,1846,-923,1,0.7119128770105674,0
925,1850,-925,1,0.30249275207723825,0
926,1852,-926,1,0.0588451232922611,0
927,1854,-927,1,0.7257018071115153,0
928,1856,-928,1,0.798397061031621,0
930,1860,-930,1,0.2143818053747304,0
931,1862,-931,1,0.995425499329585,0
932,1864,-932,1,0.28332509346110923,0
936,1872,-936,1,0.686395690013452,0
938,1876,-938,1,0.43892380426358657,0
940,1880,-940,1,0.7188974406422047,0
941,1882,-941,1,0.043246391086933955,0
942,1884,-942,1,0.6846748798252443,0
943,1886,-943,1,0.17805087622240534,0
944,1888,-944,1,0.6782084838534621,0
945,1890,-945,1,0.08541191769842804,0
946,1892,-946,1,0.03584178906381896,0
950,1900,-950,1,0.46456228390741583,0
952,1904,-952,1,0.5540880763615921,0
956,1912,-956,1,0.005728962775209845,0
957,1914,-957,1,0.9503106008397465,0
958,1916,-958,1,0.8508760732565936,0
959,1918,-959,1,0.43274602982171184,0
961,1922,-961,1,0.20139327882362168,0
962,1924,-962,1,0.5553897653336547,0
963,1926,-963,1,0.35839814045085017,0
964,1928,-964,1,0.7615593972431257,0
966,1932,-966,1,0.36167330791575136,0
968,1936,-968,1,0.5735762633633618,0
969,1938,-969,1,0.24412678206671,0
970,1940,-970,1,0.9733245264607175,0
971,1942,-971,1,0.13725033750237736,0
972,1944,-972,1,0.6656687709064223,0
977,1954,-977,1,0.048419548471126395,0
978,1956,-978,1,0.3993777233670214,0
979,1958,-979,1,0.013747603049074741,0
980,1960,-980,1,0.4472552226318177,0
981,1962,-981,1,0.004294097071642855,0
983,1966,-983,1,0.754405908083023,0
984,1968,-984,1,0.5146686502093525,0
985,1970,-985,1,0.7040722640221079,0
986,1972,-986,1,0.4570304814289331,0
987,1974,-987,1,0.49704952962055526,0
988,1976,-988,1,0.34235575575627597,0
989,1978,-989,1,0.09799544667130211,0
992,1984,-992,1,0.8964416270149913,0
993,1986,-993,1,0.5843316027501552,0
995,1990,-995,1,0.6045357658916097,0
996,1992,-996,1,0.9930209194707577,0
1001,2002,-1001,1,0.2581402322469647,0
1002,2004,-1002,1,0.8431807423477233,0
1003,2006,-1003,1,0.6236655085798576,0
1004,2008,-1004,1,0.3291255557534515,0
1006,2012,-1006,1,0.635306020576123,0
1007,2014,-1007,1,0.7121054719898875,0
1008,2016,-1008,1,0.43559776244723314,0
1009,2018,-1009,1,0.43995286349391827,0
1010,2020,-1010,1,0.01258617727264666,0
1011,2022,-1011,1,0.1122106239955114,0
1012,2024,-1012,1,0.34965407775203494,0
1013,2026,-1013,1,0.43466180735234217,0
1016,2032,-1016,1,0.6835179290935883,0
1018,2036,-1018,1,0.8466291340285261,0
1020,2040,-1020,1,0.9064288668562859,0
1021,2042,-1021,1,0.9547268535695105,0
1023,2046,-1023,1,0.6588710079728158,0
1024,2048,-1024,1,0.9288386653384189,0
1025,2050,-1025,1,0.04034877242585144,0
1026,2052,-1026,1,0.20352462880318478,0
1027,2054,-1027,1,0.8493498842712918,0
1028,2056,-1028,1,0.878733511768389,0
1030,2060,-1030,1,0.6572338109766162,0
1031,2062,-1031,1,0.5907545599193242,0
1032,2064,-1032,1,0.21043713523994256,0
1033,2066,-1033,1,0.23116082485583245,0
1036,2072,-1036,1,0.8893319658547162,0
1038,2076,-1038,1,0.30479441540745855,0
1040,2080,-1040,1,0.7292370490473653,0
1041,2082,-1041,1,0.9888227893833554,0
1042,2084,-1042,1,0.293823906281909,0
1043,2086,-1043,1,0.4947406416316523,0
1044,2088,-1044,1,0.11999283591820209,0
1045,2090,-1045,1,0.81918683402766,0
1046,2092,-1046,1,0.977973148982821,0
1047,2094,-1047,1,0.2668920270816254,0
1048,2096,-1048,1,0.13101815847042586,0
1049,2098,-1049,1,0.29065685616336034,0
1050,2100,-1050,1,0.3327839284371147,0
1051,2102,-1051,1,0.5839302903327875,0
1052,2104,-1052,1,0.12364086373304195,0
1053,2106,-1053,1,0.6022257927693139,0
1054,2108,-1054,1,0.7566379248539474,0
1056,2112,-1056,1,0.8339829030737961,0
1057,2114,-1057,1,0.8135101565597018,0
1059,2118,-1059,1,0.3593736756392877,0
1060,2120,-1060,1,0.7917226937892354,0
1061,2122,-1061,1,0.7582495257064175,0
1062,2124,-1062,1,0.08556549423566939,0
1065,2130,-1065,1,0.19163522336434358,0
1066,2132,-1066,1,0.04711556949765827,0
1067,2134,-1067,1,0.5673541213915615,0
1068,2136,-1068,1,0.20080239673039169,0
1069,2138,-1069,1,0.6814209927745024,0
1070,2140,-1070,1,0.9922049695018779,0
1071,2142,-1071,1,0.13272325989999745,0
1074,2148,-1074,1,0.2664455048205998,0
1075,2150,-1075,1,0.286335432375068,0
1076,2152,-1076,1,0.5336422665043877,0
1077,2154,-1077,1,0.7957948716408026,0
1079,2158,-1079,1,0.811774988797998,0
1080,2160,-1080,1,0.5145990096230075,0
1081,2162,-1081,1,0.4378398588185436,0
1083,2166,-1083,1,0.8963685548586672,0
1084,2168,-1084,1,0.44034964420688927,0
1085,2170,-1085,1,0.8540333140479703,0
1087,2174,-1087,1,0.3598191006966457,0
1088,2176,-1088,1,0.11256895315817861,0
1089,2178,-1089,1,0.34111398535346116,0
1090,2180,-1090,1,0.6219923773527805,0
1092,2184,-1092,1,0.19600290852008806,0
1094,2188,-1094,1,0.5484476692270713,0
1095,2190,-1095,1,0.20571486028933694,0
1097,2194,-1097,1,0.13349090433707966,0
1098,2196,-1098,1,0.258208633564766,0
1099,2198,-1099,1,0.03655234082583059,0
1100,2200,-1100,1,0.879381280984287,0
1102,2204,-1102,1,0.10601426692192462,0
1105,2210,-1105,1,0.38227648776108847,0
1106,2212,-1106,1,0.34785710194138975,0
1107,2214,-1107,1,0.46049862015509757,0
1108,2216,-1108,1,0.07045268067784405,0
1109,2218,-1109,1,0.08661262697554462,0
1110,2220,-1110,1,0.7034571954122064,0
1111,2222,-1111,1,0.9725824227139951,0
1112,2224,-1112,1,0.8600137585705114,0
1113,2226,-1113,1,0.4214828303480621,0
1114,2228,-1114,1,0.37582770850396885,0
1116,2232,-1116,1,0.6708224092403312,0
1117,2234,-1117,1,0.9955056716374786,0
1118,2236,-1118,1,0.4820581797037966,0
1119,2238,-1119,1,0.4127783012463677,0
1120,2240,-1120,1,0.7030520668524799,0
1121,2242,-1121,1,0.7909403809683805,0
1122,2244,-1122,1,0.02073296891824572,0
1124,2248,-1124,1,0.27745139831677956,0
1126,2252,-1126,1,0.8815569340193249,0
1127,2254,-1127,1,0.38501950800721185,0
1129,2258,-1129,1,0.6806468828699651,0
1132,2264,-1132,1,0.9839907440684594,0
1134,2268,-1134,1,0.8857702092452195,0
1137,2274,-1137,1,0.39148062128226513,0
1139,2278,-1139,1,0.4133803814254279,0
1140,2280,-1140,1,0.007806701934303106,0
1141,2282,-1141,1,0.8027572520749932,0
1144,2288,-1144,1,0.5207363636552336,0
1145,2290,-1145,1,0.42429979961098163,0
1146,2292,-1146,1,0.92339346882439,0
1147,2294,-1147,1,0.38395630494108257,0
1150,2300,-1150,1,0.027900885488735816,0
1151,2302,-1151,1,0.3738255235189182,0
1155,2310,-1155,1,0.8554091214939398,0
1156,2312,-1156,1,0.9921386895876081,0
1157,2314,-1157,1,0.2839073361715313,0
1158,2316,-1158,1,0.35451746577988497,0
1159,2318,-1159,1,0.5633663943317064,0
1160,2320,-1160,1,0.676014455410255,0
1163,2326,-1163,1,0.12998289595661916,0
1164,2328,-1164,1,0.4151489473293348,0
1165,2330,-1165,1,0.0888900625131902,0
1167,2334,-1167,1,0.11633157270650696,0
1168,2336,-1168,1,0.09339789149463373,0
1171,2342,-1171,1,0.9787470815801842,0
1172,2344,-1172,1,0.06957567762142691,0
1173,2346,-1173,1,0.338565518809291,0
1174,2348,-1174,1,0.33471201894659397,0
1176,2352,-1176,1,0.8130377239266512,0
1177,2354,-1177,1,0.698006131775623,0
1180,2360,-1180,1,0.5437335811551609,0
1181,2362,-1181,1,0.7101501501919244,0
1182,2364,-1182,1,0.8207530076177716,0
1184,2368,-1184,1,0.5780251669055152,0
1186,2372,-1186,1,0.471699656962148,0
1189,2378,-1189,1,0.7403903237136683,0
1190,2380,-1190,1,0.31418269999665216,0
1191,2382,-1191,1,0.034658218528672236,0
1193,2386,-1193,1,0.3725736516540483,0
1194,2388,-1194,1,0.5268919972560344,0
1195,2390,-1195,1,0.4387807096580484,0
1196,2392,-1196,1,0.9214815868342521,0
1197,2394,-1197,1,0.8006849399255392,0
1198,2396,-1198,1,0.9285437176750768,0
1199,2398,-1199,1,0.058853099185521285,0
1201,2402,-1201,1,0.7619103438849393,0
1204,2408,-1204,1,0.7248176192634611,0
1206,2412,-1206,1,0.3638224801564507,0
1207,2414,-1207,1,0.31649952777341483,0
1208,2416,-1208,1,0.0584181301062725,0
1209,2418,-1209,1,0.8076826790432876,0
1214,2428,-1214,1,0.6273057715934711,0
1217,2434,-1217,1,0.41788764798940503,0
1218,2436,-1218,1,0.9363683760508565,0
1219,2438,-1219,1,0.6894481456028289,0
1221,2442,-1221,1,0.5106361379712474,0
1223,2446,-1223,1,0.9805235931052002,0
1224,2448,-1224,1,0.8380565532095875,0
1227,2454,-1227,1,0.510216663452932,0
1228,2456,-1228,1,0.07966219860806834,0
1229,2458,-1229,1,0.7329065090057318,0
1231,2462,-1231,1,0.08161320268544381,0
1232,2464,-1232,1,0.11184251222181074,0
1233,2466,-1233,1,0.12396563784153147,0
1236,2472,-1236,1,0.5235224210243453,0
1238,2476,-1238,1,0.14571601976029402,0
1239,2478,-1239,1,0.5560396346797616,0
1241,2482,-1241,1,0.23867103650767774,0
1242,2484,-1242,1,0.1656706286697326,0
1243,2486,-1243,1,0.3989058001493738,0
1244,2488,-1244,1,0.38421393261775616,0
1245,2490,-1245,1,0.489255704254245,0
1246,2492,-1246,1,0.9433257118852394,0
1247,2494,-1247,1,0.11391648340627203,0
1248,2496,-1248,1,0.05330345261676339,0
1249,2498,-1249,1,0.4343906855280475,0
1250,2500,-1250,1,0.3012896189404082,0
1252,2504,-1252,1,0.04088297855767831,0
1254,2508,-1254,1,0.028639111476801316,0
1255,2510,-1255,1,0.7421450308232417,0
1256,2512,-1256,1,0.46667730576053046,0
1258,2516,-1258,1,0.26421923614882126,0
1260,2520,-1260,1,0.5790747686846398,0
1261,2522,-1261,1,0.527343028846784,0
1264,2528,-1264,1,0.8681075912593977,0
1265,2530,-1265,1,0.6037038566643338,0
1267,2534,-1267,1,0.020532006419582638,0
1268,2536,-1268,1,0.8235872171353779,0
1269,2538,-1269,1,0.9571287151902419,0
1270,2540,-1270,1,0.6731147098289506,0
1271,2542,-1271,1,0.47423416803107377,0
1272,2544,-1272,1,0.21974230197665034,0
1273,2546,-1273,1,0.13997509018293874,0
1274,2548,-1274,1,0.4655828400584867,0
1275,2550,-1275,1,0.3107368216888007,0
1276,2552,-1276,1,0.6777389543857564,0
1277,2554,-1277,1,0.4362235462753401,0
1278,2556,-1278,1,0.45687851788689626,0
1279,2558,-1279,1,0.48140399492434205,0
1280,2560,-1280,1,0.29194196218160096,0
1281,2562,-1281,1,0.42043335752274924,0
1282,2564,-1282,1,0.2982599994447983,0
1283,2566,-1283,1,0.3815936107140485,0
1285,2570,-1285,1,0.7836115851534862,0
1286,2572,-1286,1,0.03944341419963482,0
1287,2574,-1287,1,0.9261162963573598,0
1288,2576,-1288,1,0.008662615135264007,0
1289,2578,-1289,1,0.38262566828617117,0
1290,2580,-1290,1,0.3104532425500163,0
1291,2582,-1291,1,0.7305665316935,0
1292,2584,-1292,1,0.11920468969781062,0
1293,2586,-1293,1,0.8514082955470483,0
1295,2590,-1295,1,0.49239650643344235,0
1300,2600,-1300,1,0.3590454893203179,0
1301,2602,-1301,1,0.6610049643809308,0
1302,2604,-1302,1,0.42617364482669684,0
1303,2606,-1303,1,0.7835387697332942,0
1304,2608,-1304,1,0.3552422317523901,0
1305,2610,-1305,1,0.29479984703264606,0
1306,2612,-1306,1,0.2613743811181204,0
1307,2614,-1307,1,0.09238422250776102,0
1309,2618,-1309,1,0.5464971828236571,0
1310,2620,-1310,1,0.0482057753760986,0
1311,2622,-1311,1,0.4893580203135405,0
1313,2626,-1313,1,0.03894328363000821,0
1314,2628,-1314,1,0.6179387431733975,0
1316,2632,-1316,1,0.769695936439994,0
1317,2634,-1317,1,0.9677807621678488,0
1318,2636,-1318,1,0.959248078786823,0
1319,2638,-1319,1,0.8343117253218628,0
1320,2640,-1320,1,0.37251054515123927,0
1321,2642,-1321,1,0.4043465675173017,0
1322,2644,-1322,1,0.16041661941602436,0
1323,2646,-1323,1,0.18772328912512926,0
1324,2648,-1324,1,0.8785213309328171,0
1326,2652,-1326,1,0.0924979341404164,0
1327,2654,-1327,1,0.6916401563258509,0
1330,2660,-1330,1,0.77380196210379,0
1331,2662,-1331,1,0.15179324705194597,0
1332,2664,-1332,1,0.21837422795973038,0
1333,2666,-1333,1,0.623239723238912,0
1334,2668,-1334,1,0.26393735714550826,0
1335,2670,-1335,1,0.6867229301878632,0
1338,2676,-1338,1,0.12948102663979622,0
1341,2682,-1341,1,0.9353341753705742,0
1345,2690,-1345,1,0.1201566927440304,0
1346,2692,-1346,1,0.5691985725190314,0
1347,2694,-1347,1,0.47065596098119655,0
1348,2696,-1348,1,0.9909195998287743,0
1349,2698,-1349,1,0.2971422737256205,0
1350,2700,-1350,1,0.1668246838479438,0
1352,2704,-1352,1,0.6011214403106566,0
1353,2706,-1353,1,0.7821181372573465,0
1355,2710,-1355,1,0.9813169113789709,0
1358,2716,-1358,1,0.49791028396035353,0
1359,2718,-1359,1,0.5474189777693576,0
1360,2720,-1360,1,0.9173729849221958,0
1361,2722,-1361,1,0.563500757112028,0
1362,2724,-1362,1,0.9763039265134571,0
1363,2726,-1363,1,0.19218776222182254,0
1364,2728,-1364,1,0.35267313190228067,0
1366,2732,-1366,1,0.9981268736359026,0
1370,2740,-1370,1,0.24419340622379992,0
1371,2742,-1371,1,0.18827293807871415,0
1373,2746,-1373,1,0.8167885114827961,0
1374,2748,-1374,1,0.9879205378968503,0
1375,2750,-1375,1,0.8294284688591668,0
1376,2752,-1376,1,0.09601075587044461,0
1378,2756,-1378,1,0.6577457187939467,0
1380,2760,-1380,1,0.3126717369271561,0
1381,2762,-1381,1,0.2859678847430307,0
1382,2764,-1382,1,0.9452674339944032,0
1383,2766,-1383,1,0.6960672109819421,0
1384,2768,-1384,1,0.03194691128591032,0
1385,2770,-1385,1,0.3987941524322842,0
1386,2772,-1386,1,0.5213599230837954,0
1387,2774,-1387,1,0.6829264489396529,0
1389,2778,-1389,1,0.7526079981322371,0
1390,2780,-1390,1,0.012606788593299001,0
1393,2786,-1393,1,0.6927338406587619,0
1396,2792,-1396,1,0.36012895289290425,0
1399,2798,-1399,1,0.6299418755840444,0
1400,2800,-1400,1,0.48282842906683987,0
1404,2808,-1404,1,0.44249563817786475,0
1405,2810,-1405,1,0.2634390721474711,0
1406,2812,-1406,1,0.7864595892002927,0
1408,2816,-1408,1,0.9706379505099749,0
1409,2818,-1409,1,0.17417494686667356,0
1411,2822,-1411,1,0.4320914275068096,0
1412,2824,-1412,1,0.24636777029453283,0
1413,2826,-1413,1,0.5688145520293402,0
1414,2828,-1414,1,0.8746115011107286,0
1415,2830,-1415,1,0.010021311871904914,0
1417,2834,-1417,1,0.24738159237321722,0
1418,2836,-1418,1,0.08761519450456201,0
1422,2844,-1422,1,0.680550027362305,0
1423,2846,-1423,1,0.5554160218526373,0
1424,2848,-1424,1,0.008907319071394193,0
1427,2854,-1427,1,0.7028315911701092,0
1428,2856,-1428,1,0.5281391276399846,0
1429,2858,-1429,1,0.5937997884034035,0
1430,2860,-1430,1,0.7937619757455376,0
1431,2862,-1431,1,0.19094640817208808,0
1432,2864,-1432,1,0.28484142713560767,0
1433,2866,-1433,1,0.9688333485132363,0
1434,2868,-1434,1,0.6920706124918444,0
1435,2870,-1435,1,0.8066245927877738,0
1437,2874,-1437,1,0.7088276576470777,0
1438,2876,-1438,1,0.8142662263522042,0
1439,2878,-1439,1,0.43977190532899624,0
1440,2880,-1440,1,0.038773770986160416,0
1441,2882,-1441,1,0.40770955640255413,0
1442,2884,-1442,1,0.625755600255117,0
1445,2890,-1445,1,0.1068278204422447,0
1446,2892,-1446,1,0.35950765275522323,0
1448,2896,-1448,1,0.29199610549784594,0
1450,2900,-1450,1,0.7821574082829786,0
1451,2902,-1451,1,0.2668952704939014,0
1452,2904,-1452,1,0.011013234049229714,0
1453,2906,-1453,1,0.960328105023374,0
1454,2908,-1454,1,0.5785589647785632,0
1455,2910,-1455,1,0.9331684849294827,0
1456,2912,-1456,1,0.4152983300838844,0
1457,2914,-1457,1,0.08771044076404055,0
1459,2918,-1459,1,0.25741071451042563,0
1461,2922,-1461,1,0.1876967205674387,0
1462,2924,-1462,1,0.7334416800369168,0
1463,2926,-1463,1,0.808070570777482,0
1465,2930,-1465,1,0.6129640212840411,0
1466,2932,-1466,1,0.979943620996468,0
1467,2934,-1467,1,0.4169854337168196,0
1468,2936,-1468,1,0.5924499517222276,0
1469,2938,-1469,1,0.40325363985837603,0
1473,2946,-1473,1,0.906522650959809,0
1474,2948,-1474,1,0.529725836447089,0
1475,2950,-1475,1,0.567334459667099,0
1476,2952,-1476,1,0.23101897932102822,0
1477,2954,-1477,1,0.014577144704674971,0
1478,2956,-1478,1,0.0023566634975672462,0
1480,2960,-1480,1,0.08314460754802688,0
1481,2962,-1481,1,0.21918116794056963,0
1482,2964,-1482,1,0.11873120973929918,0
1483,2966,-1483,1,0.46900850644597325,0
1484,2968,-1484,1,0.1543063206391937,0
1485,2970,-1485,1,0.4542715398107672,0
1486,2972,-1486,1,0.061966978782184934,0
1488,2976,-1488,1,0.831572054921518,0
1492,2984,-1492,1,0.8778116362129601,0
1493,2986,-1493,1,0.3954892789558959,0
1494,2988,-1494,1,0.7445990174069927,0
1495,2990,-1495,1,0.6099536922530248,0
1496,2992,-1496,1,0.8995783264801003,0
1501,3002,-1501,1,0.3967472114829038,0
1503,3006,-1503,1,0.004746581880431311,0
1505,3010,-1505,1,0.20945626854165,0
1506,3012,-1506,1,0.17992802645871964,0
1507,3014,-1507,1,0.6785189776489707,0
1510,3020,-1510,1,0.23050510339336527,0
1512,3024,-1512,1,0.775690116828004,0
1513,3026,-1513,1,0.3298040824074271,0
1514,3028,-1514,1,0.2692803156548842,0
1517,3034,-1517,1,0.30153888739986134,0
1518,3036,-1518,1,0.8055999578144185,0
1519,3038,-1519,1,0.8502186237528385,0
1521,3042,-1521,1,0.36311999644977444,0
1525,3050,-1525,1,0.1885206668845999,0
1527,3054,-1527,1,0.5208446420602632,0
1529,3058,-1529,1,0.6767583367211202,0
1531,3062,-1531,1,0.36789613799114584,0
1534,3068,-1534,1,0.8980054066175162,0
1535,3070,-1535,1,0.7170266981587404,0
1537,3074,-1537,1,0.7174452628731561,0
1539,3078,-1539,1,0.3038126167177312,0
1540,3080,-1540,1,0.4406023356365477,0
1541,3082,-1541,1,0.9726515867874826,0
1542,3084,-1542,1,0.4832607681038994,0
1543,3086,-1543,1,0.7804520266185135,0
1545,3090,-1545,1,0.6413753533065629,0
1546,3092,-1546,1,0.30264555934076376,0
1547,3094,-1547,1,0.8136295832820438,0
1548,3096,-1548,1,0.6669118839531788,0
1549,3098,-1549,1,0.24555392859929137,0
1553,3106,-1553,1,0.5471071955704728,0
1554,3108,-1554,1,0.12313720569177722,0
1555,3110,-1555,1,0.08188642753037334,0
1557,3114,-1557,1,0.25730109722577565,0
1565,3130,-1565,1,0.8304594989199112,0
1566,3132,-1566,1,0.9801304655013228,0
1568,3136,-1568,1,0.18385004691111595,0
1569,3138,-1569,1,0.24481806976251752,0
1570,3140,-1570,1,0.05804016808037793,0
1571,3142,-1571,1,0.42082464735006264,0
1572,3144,-1572,1,0.5568481706853211,0
1573,3146,-1573,1,0.7563865335442179,0
1574,3148,-1574,1,0.8792824525252366,0
1575,3150,-1575,1,0.7950872643799201,0
1576,3152,-1576,1,0.5798300396107345,0
1579,3158,-1579,1,0.7029508524380987,0
1582,3164,-1582,1,0.8885426388661121,0
1584,3168,-1584,1,0.33932341712402037,0
1587,3174,-1587,1,0.06367335098588867,0
1589,3178,-1589,1,0.3018838062812368,0
1591,3182,-1591,1,0.7074013792816569,0
1592,3184,-1592,1,0.0903391579819044,0
1593,3186,-1593,1,0.32043834123841153,0
1595,3190,-1595,1,0.8159106176121073,0
1596,3192,-1596,1,0.6772086478524164,0
1598,3196,-1598,1,0.8829832513274397,0
1599,3198,-1599,1,0.058773847455069084,0
1600,3200,-1600,1,0.5208946038737807,0
1601,3202,-1601,1,0.18908077351964903,0
1602,3204,-1602,1,0.6836777505172885,0
1603,3206,-1603,1,0.9461112685149368,0
1604,3208,-1604,1,0.8486053305179335,0
1608,3216,-1608,1,0.1592476175411215,0
1609,3218,-1609,1,0.11112393778454566,0
1610,3220,-1610,1,0.3210278625973252,0
1611,3222,-1611,1,0.9995179629715732,0
1615,3230,-1615,1,0.4414137800299841,0
1616,3232,-1616,1,0.31129705365592175,0
1617,3234,-1617,1,0.9920886402543496,0
1618,3236,-1618,1,0.8395147946402745,0
1620,3240,-1620,1,0.39453372759949634,0
1622,3244,-1622,1,0.5198703470629377,0
1623,3246,-1623,1,0.6643497179019042,0
1625,3250,-1625,1,0.9290854687897028,0
1626,3252,-1626,1,0.21199139007226797,0
1627,3254,-1627,1,0.1810808929623744,0
1628,3256,-1628,1,0.9736314182185112,0
1630,3260,-1630,1,0.6363795315231162,0
1631,3262,-1631,1,0.1409601781962605,0
1632,3264,-1632,1,0.3581862378677795,0
1634,3268,-1634,1,0.8887732089284768,0
1637,3274,-1637,1,0.3369663516654111,0
1639,3278,-1639,1,0.057711731387702137,0
1640,3280,-1640,1,0.9489242312106427,0
1642,3284,-1642,1,0.7469001449179969,0
1644,3288,-1644,1,0.6100184393917438,0
1645,3290,-1645,1,0.650461912355293,0
1647,3294,-1647,1,0.5673764791316369,0
1648,3296,-1648,1,0.24411327496960267,0
1650,3300,-1650,1,0.6086163149090414,0
1651,3302,-1651,1,0.32453772299931727,0
1652,3304,-1652,1,0.11797655719494504,0
1653,3306,-1653,1,0.8127058676740927,0
1654,3308,-1654,1,0.41876222632327254,0
1655,3310,-1655,1,0.20419854813053895,0
1657,3314,-1657,1,0.2944069329397456,0
1663,3326,-1663,1,0.7539540868830241,0
1664,3328,-1664,1,0.27352660587235134,0
1665,3330,-1665,1,0.3850440286306116,0
1666,3332,-1666,1,0.6688042703586315,0
1667,3334,-1667,1,0.587368855076689,0
1668,3336,-1668,1,0.7047962955358931,0
1669,3338,-1669,1,0.04035865336734501,0
1670,3340,-1670,1,0.7371083305674697,0
1671,3342,-1671,1,0.21821568177266926,0
1674,3348,-1674,1,0.7016533979451035,0
1675,3350,-1675,1,0.2467452389373097,0
1676,3352,-1676,1,0.8879799713394818,0
1677,3354,-1677,1,0.9295805342001725,0
1678,3356,-1678,1,0.08279966818209916,0
1679,3358,-1679,1,0.21319898020833716,0
1680,3360,-1680,1,0.18524086533575423,0
1682,3364,-1682,1,0.4012930515652394,0
1685,3370,-1685,1,0.470879760336836,0
1688,3376,-1688,1,0.3531560938405034,0
1689,3378,-1689,1,0.904117406155267,0
1690,3380,-1690,1,0.3950314552568218,0
1692,3384,-1692,1,0.8582766469119202,0
1693,3386,-1693,1,0.9062507212074536,0
1695,3390,-1695,1,0.45214850219990854,0
1698,3396,-1698,1,0.6002358252344704,0
1699,3398,-1699,1,0.41786553573743,0
1700,3400,-1700,1,0.2681149039799906,0
1701,3402,-1701,1,0.7341799881049461,0
1702,3404,-1702,1,0.6232878709599279,0
1703,3406,-1703,1,0.014544754228840495,0
1705,3410,-1705,1,0.27488276616205476,0
1706,3412,-1706,1,0.649246461366213,0
1707,3414,-1707,1,0.6065618964829272,0
1708,3416,-1708,1,0.17619305438754085,0
1710,3420,-1710,1,0.5631229657183758,0
1711,3422,-1711,1,0.677120098260674,0
1713,3426,-1713,1,0.6368304071907319,0
1714,3428,-1714,1,0.9374108631540651,0
1715,3430,-1715,1,0.12878174494459116,0
1720,3440,-1720,1,0.7392230450673261,0
1721,3442,-1721,1,0.16489806516256433,0
1722,3444,-1722,1,0.47071909365328046,0
1723,3446,-1723,1,0.24572367802239803,0
1724,3448,-1724,1,0.49941032165163723,0
1725,3450,-1725,1,0.8525974816714318,0
1726,3452,-1726,1,0.08499861718071611,0
1727,3454,-1727,1,0.20100603963052277,0
1728,3456,-1728,1,0.3460436636402231,0
1729,3458,-1729,1,0.7877797642372438,0
1733,3466,-1733,1,0.16594971219979182,0
1734,3468,-1734,1,0.600272794907611,0
1735,3470,-1735,1,0.5050582023175361,0
1736,3472,-1736,1,0.847064629156768,0
1737,3474,-1737,1,0.2983355370393814,0
1740,3480,-1740,1,0.5602871930098828,0
1741,3482,-1741,1,0.7476730259123984,0
1742,3484,-1742,1,0.40825506038979975,0
1743,3486,-1743,1,0.3361110164487968,0
1744,3488,-1744,1,0.375194452859139,0
1745,3490,-1745,1,0.3267723787290845,0
1746,3492,-1746,1,0.8810890805593232,0
1747,3494,-1747,1,0.9566576657987684,0
1749,3498,-1749,1,0.852783074932125,0
1750,3500,-1750,1,0.40268904670416505,0
1751,3502,-1751,1,0.12061946320711825,0
1752,3504,-1752,1,0.20156158855403683,0
1753,3506,-1753,1,0.05961575569023769,0
1754,3508,-1754,1,0.31734538114807875,0
1755,3510,-1755,1,0.08269021932344733,0
1756,3512,-1756,1,0.5856487055323375,0
1757,3514,-1757,1,0.9084505538886268,0
1758,3516,-1758,1,0.8480025008106514,0
1759,3518,-1759,1,0.40834512225860686,0
1762,3524,-1762,1,0.5597580264232692,0
1763,3526,-1763,1,0.31030660977319124,0
1764,3528,-1764,1,0.5143007234435827,0
1765,3530,-1765,1,0.8023499180506098,0
1767,3534,-1767,1,0.3442110249444793,0
1768,3536,-1768,1,0.9830436757853539,0
1769,3538,-1769,1,0.8200896414942289,0
1770,3540,-1770,1,0.2975003615074421,0
1771,3542,-1771,1,0.6943943767001547,0
1772,3544,-1772,1,0.006253801077669707,0
1775,3550,-1775,1,0.9909697091166687,0
1777,3554,-1777,1,0.9489667469110361,0
1779,3558,-1779,1,0.026530425224578047,0
1780,3560,-1780,1,0.599852645750055,0
1781,3562,-1781,1,0.663225677518443,0
1782,3564,-1782,1,0.8768507920458545,0
1784,3568,-1784,1,0.14789928550238385,0
1787,3574,-1787,1,0.13062795525706383,0
1788,3576,-1788,1,0.026980502119903438,0
1789,3578,-1789,1,0.4537296409549102,0
1794,3588,-1794,1,0.1158612311946069,0
1795,3590,-1795,1,0.6495289241645266,0
1798,3596,-1798,1,0.7824404292610306,0
1799,3598,-1799,1,0.7208596318188323,0
1800,3600,-1800,1,0.1091013692014221,0
1801,3602,-1801,1,0.77598209234651,0
1802,3604,-1802,1,0.47452422105239267,0
1803,3606,-1803,1,0.47793367018908595,0
1805,3610,-1805,1,0.8165864931057374,0
1806,3612,-1806,1,0.526522932242924,0
1807,3614,-1807,1,0.9736881181960947,0
1810,3620,-1810,1,0.37182442827308293,0
1811,3622,-1811,1,0.42357410712442667,0
1812,3624,-1812,1,0.7939708805882312,0
1814,3628,-1814,1,0.32625899650684576,0
1815,3630,-1815,1,0.29622623894421785,0
1817,3634,-1817,1,0.5596545877392045,0
1818,3636,-1818,1,0.8519056456240123,0
1820,3640,-1820,1,0.99606272599559,0
1822,3644,-1822,1,0.6749481856877332,0
1824,3648,-1824,1,0.8004790301969135,0
1825,3650,-1825,1,0.07767865378775574,0
1826,3652,-1826,1,0.6793404343131392,0
1827,3654,-1827,1,0.44695308136875755,0
1828,3656,-1828,1,0.15172277222917807,0
1830,3660,-1830,1,0.4365448112444811,0
1831,3662,-1831,1,0.8931615247832054,0
1832,3664,-1832,1,0.7801922435254913,0
1833,3666,-1833,1,0.6733208376365218,0
1835,3670,-1835,1,0.9316422339351227,0
1836,3672,-1836,1,0.735883037903755,0
1837,3674,-1837,1,0.42596011045790494,0
1839,3678,-1839,1,0.10319155040444938,0
1840,3680,-1840,1,0.47479465830625844,0
1841,3682,-1841,1,0.5645744818902002,0
1842,3684,-1842,1,0.02732089667226878,0
1845,3690,-1845,1,0.7886588349232304,0
1846,3692,-1846,1,0.47259688767370867,0
1847,3694,-1847,1,0.9364304414406368,0
1855,3710,-1855,1,0.5866374867145585,0
1857,3714,-1857,1,0.31327525303872883,0
1858,3716,-1858,1,0.2042194924250893,0
1862,3724,-1862,1,0.22305817292641295,0
1864,3728,-1864,1,0.22386706389224054,0
1865,3730,-1865,1,0.8489734217467425,0
1866,3732,-1866,1,0.5409039930690615,0
1870,3740,-1870,1,0.1938849490985094,0
1872,3744,-1872,1,0.8832272678139276,0
1876,3752,-1876,1,0.8026447382240739,0
1878,3756,-1878,1,0.02750339661790857,0
1879,3758,-1879,1,0.453116662883878,0
1880,3760,-1880,1,0.02836774012404575,0
1881,3762,-1881,1,0.5249339442532792,0
1882,3764,-1882,1,0.8044852181776427,0
1883,3766,-1883,1,0.3613149509395277,0
1884,3768,-1884,1,0.601929963564265,0
1885,3770,-1885,1,0.7871583565356662,0
1886,3772,-1886,1,0.9895182341075491,0
1887,3774,-1887,1,0.878306953627208,0
1888,3776,-1888,1,0.719200678786179,0
1891,3782,-1891,1,0.9870845299435149,0
1892,3784,-1892,1,0.976956147333802,0
1893,3786,-1893,1,0.09174214999410524,0
1894,3788,-1894,1,0.16732273524696972,0
1895,3790,-1895,1,0.1745441367702283,0
1896,3792,-1896,1,0.4403676098609479,0
1899,3798,-1899,1,0.4027566418252386,0
1900,3800,-1900,1,0.2642689582846929,0
1901,3802,-1901,1,0.7864863295808663,0
1903,3806,-1903,1,0.061209494958959776,0
1905,3810,-1905,1,0.5740816240408404,0
1907,3814,-1907,1,0.1463780050426008,0
1908,3816,-1908,1,0.18288432076557049,0
1909,3818,-1909,1,0.5322789604843038,0
1912,3824,-1912,1,0.8825123993856994,0
1919,3838,-1919,1,0.6223171974731412,0
1920,3840,-1920,1,0.32183274580477694,0
1921,3842,-1921,1,0.3772419708835528,0
1923,3846,-1923,1,0.9909143971027283,0
1926,3852,-1926,1,0.9363397151431913,0
1928,3856,-1928,1,0.7647854288314427,0
1929,3858,-1929,1,0.9968045507277732,0
1931,3862,-1931,1,0.6699139326800022,0
1934,3868,-1934,1,0.9876151398774224,0
1935,3870,-1935,1,0.37662855169143006,0
1936,3872,-1936,1,0.542623919663661,0
1938,3876,-1938,1,0.10763473320424344,0
1939,3878,-1939,1,0.26578227347367434,0
1941,3882,-1941,1,0.29414818955689603,0
1942,3884,-1942,1,0.9289341230836853,0
1943,3886,-1943,1,0.09323635059492841,0
1945,3890,-1945,1,0.3427500532898148,0
1947,3894,-1947,1,0.797082511132468,0
1948,3896,-1948,1,0.31228996756786487,0
1949,3898,-1949,1,0.11626331470902929,0
1952,3904,-1952,1,0.27382061312712025,0
1954,3908,-1954,1,0.697867703272042,0
1956,3912,-1956,1,0.6157468418646302,0
1957,3914,-1957,1,0.4477731381525837,0
1958,3916,-1958,1,0.7292631475854697,0
1961,3922,-1961,1,0.7962462655111157,0
1962,3924,-1962,1,0.3852115245527099,0
1964,3928,-1964,1,0.7094081019059195,0
1966,3932,-1966,1,0.6097269030480527,0
1968,3936,-1968,1,0.021876260652914148,0
1969,3938,-1969,1,0.6409068018157343,0
1971,3942,-1971,1,0.16915663599987885,0
1974,3948,-1974,1,0.7764904492628579,0
1976,3952,-1976,1,0.5892426025639638,0
1979,3958,-1979,1,0.6437800275314807,0
1980,3960,-1980,1,0.4441010981900453,0
1981,3962,-1981,1,0.15491885568897013,0
1983,3966,-1983,1,0.6478793839235883,0
1985,3970,-1985,1,0.10014107832093733,0
1986,3972,-1986,1,0.7455170874615658,0
1987,3974,-1987,1,0.7262673121739703,0
1989,3978,-1989,1,0.9764987622111245,0
1990,3980,-1990,1,0.666255415643891,0
1991,3982,-1991,1,0.395206793142974,0
1995,3990,-1995,1,0.21408039174823335,0
1997,3994,-1997,1,0.5005535148546827,0
1998,3996,-1998,1,0.08895372940940616,0
2000,4000,-2000,1,0.3117827911067388,0
2001,4002,-2001,1,0.9162501075390663,0
2002,4004,-2002,1,0.5454356276050097,0
2003,4006,-2003,1,0.07689740967741243,0
2005,4010,-2005,1,0.505331103282152,0
2006,4012,-2006,1,0.7364813889500826,0
2008,4016,-2008,1,0.05167046651505913,0
2010,4020,-2010,1,0.8242608173844042,0
2012,4024,-2012,1,0.36398237602730665,0
2013,4026,-2013,1,0.46729793368697803,0
2014,4028,-2014,1,0.8030146540877935,0
2015,4030,-2015,1,0.27132246891494816,0
2016,4032,-2016,1,0.5131500591442013,0
2018,4036,-2018,1,0.5894018908404217,0
2020,4040,-2020,1,0.9005765871576349,0
2021,4042,-2021,1,0.5012567494651133,0
2022,4044,-2022,1,0.39724904384991655,0
2023,4046,-2023,1,0.5374332301999687,0
2024,4048,-2024,1,0.5156189197523349,0
2027,4054,-2027,1,0.5308638754636319,0
2028,4056,-2028,1,0.3676721479612617,0
2029,4058,-2029,1,0.6450550276883861,0
2031,4062,-2031,1,0.5926951105122686,0
2032,4064,-2032,1,0.12968090012297784,0
2034,4068,-2034,1,0.5728862642130027,0
2035,4070,-2035,1,0.06338395346731007,0
2036,4072,-2036,1,0.9780032600757915,0
2037,4074,-2037,1,0.030205580874858362,0
2039,4078,-2039,1,0.4318351763479009,0
2040,4080,-2040,1,0.6868828584704855,0
2041,4082,-2041,1,0.5298422582222739,0
2042,4084,-2042,1,0.002835882463776751,0
2044,4088,-2044,1,0.1400542888617009,0
2045,4090,-2045,1,0.8426716971734555,0
2048,4096,-2048,1,0.7097568508864429,0
2049,4098,-2049,1,0.13045112601733666,0
2051,4102,-2051,1,0.2126706041427201,0
2053,4106,-2053,1,0.6409026927702208,0
2054,4108,-2054,1,0.48795313497689896,0
2055,4110,-2055,1,0.7020294953515405,0
2057,4114,-2057,1,0.9502668910485536,0
2059,4118,-2059,1,0.6765062682018206,0
2060,4120,-2060,1,0.7354730719046938,0
2061,4122,-2061,1,0.031733938781974724,0
2064,4128,-2064,1,0.40595780143093074,0
2065,4130,-2065,1,0.15087866316014997,0
2069,4138,-2069,1,0.28421981718607336,0
2071,4142,-2071,1,0.4409291697999339,0
2072,4144,-2072,1,0.36090886620407736,0
2074,4148,-2074,1,0.1014715436831568,0
2075,4150,-2075,1,0.5892655957256617,0
2077,4154,-2077,1,0.20611369384432776,0
2078,4156,-2078,1,0.746936294639967,0
2079,4158,-2079,1,0.5595553339234964,0
2080,4160,-2080,1,0.3626352234818163,0
2082,4164,-2082,1,0.9768549264047551,0
2084,4168,-2084,1,0.5714193369466198,0
2085,4170,-2085,1,0.7055425726335773,0
2088,4176,-2088,1,0.8827597627507263,0
2090,4180,-2090,1,0.1877573250178377,0
2092,4184,-2092,1,0.4928639259798806,0
2094,4188,-2094,1,0.7308010648206545,0
2096,4192,-2096,1,0.49558227379966446,0
2101,4202,-2101,1,0.4893691353575783,0
2103,4206,-2103,1,0.45334119269999373,0
2106,4212,-2106,1,0.1900377582170143,0
2108,4216,-2108,1,0.3731180893951125,0
2109,4218,-2109,1,0.13482747846521015,0
2110,4220,-2110,1,0.45376539816220063,0
2112,4224,-2112,1,0.5699409746997088,0
2113,4226,-2113,1,0.4020896619234102,0
2114,4228,-2114,1,0.748646490564138,0
2115,4230,-2115,1,0.026208916556456074,0
2116,4232,-2116,1,0.912003717004629,0
2120,4240,-2120,1,0.10267434467158354,0
2122,4244,-2122,1,0.2714851641095001,0
2126,4252,-2126,1,0.14284905836755313,0
2127,4254,-2127,1,0.9328963282065446,0
2128,4256,-2128,1,0.029681830570410295,0
2129,4258,-2129,1,0.5421517487691736,0
2130,4260,-2130,1,0.17329362682096383,0
2131,4262,-2131,1,0.6342780985993562,0
2132,4264,-2132,1,0.1780266159498397,0
2133,4266,-2133,1,0.5129623570060506,0
2134,4268,-2134,1,0.7729299925643112,0
2135,4270,-2135,1,0.157186873278097,0
2136,4272,-2136,1,0.6061625681402573,0
2137,4274,-2137,1,0.42443758873027493,0
2139,4278,-2139,1,0.558721736340458,0
2140,4280,-2140,1,0.5433794803638372,0
2143,4286,-2143,1,0.14110401786279347,0
2145,4290,-2145,1,0.32553846609779524,0
2146,4292,-2146,1,0.7966107036321751,0
2147,4294,-2147,1,0.7601871934032836,0
2148,4296,-2148,1,0.8427996346564981,0
2150,4300,-2150,1,0.5872630159979093,0
2152,4304,-2152,1,0.4216128155601625,0
2153,4306,-2153,1,0.2118316786602843,0
2154,4308,-2154,1,0.12551441334770164,0
2157,4314,-2157,1,0.9906104649557439,0
2158,4316,-2158,1,0.9631727072495264,0
2159,4318,-2159,1,0.09931252403797353,0
2161,4322,-2161,1,0.4412152809095492,0
2162,4324,-2162,1,0.05450081093918446,0
2163,4326,-2163,1,0.890234825436998,0
2167,4334,-2167,1,0.36969096532398626,0
2168,4336,-2168,1,0.10044125394467762,0
2169,4338,-2169,1,0.6550475946464303,0
2170,4340,-2170,1,0.876948369154675,0
2172,4344,-2172,1,0.6214506456191642,0
2173,4346,-2173,1,0.569026607220437,0
2176,4352,-2176,1,0.5480005349799687,0
2177,4354,-2177,1,0.2646494022660755,0
2178,4356,-2178,1,0.9787744419699576,0
2179,4358,-2179,1,0.8894892774404042,0
2180,4360,-2180,1,0.6604177418919619,0
2182,4364,-2182,1,0.6273445650488922,0
2184,4368,-2184,1,0.6948822013059731,0
2185,4370,-2185,1,0.810285594378274,0
2186,4372,-2186,1,0.6697219854127299,0
2187,4374,-2187,1,0.9509704763865596,0
2188,4376,-2188,1,0.5351248060372251,0
2189,4378,-2189,1,0.8084624950020532,0
2190,4380,-2190,1,0.9980292738127134,0
2191,4382,-2191,1,0.19797669092356807,0
2192,4384,-2192,1,0.251000839146594,0
2193,4386,-2193,1,0.03787638843090335,0
2195,4390,-2195,1,0.8711804025287357,0
2196,4392,-2196,1,0.33569571376036855,0
2197,4394,-2197,1,0.46448660819148246,0
2198,4396,-2198,1,0.240869866888892,0
2199,4398,-2199,1,0.9266201380326898,0
2200,4400,-2200,1,0.6828315239317674,0
2201,4402,-2201,1,0.6674743772435273,0
2205,4410,-2205,1,0.8152177569191986,0
2207,4414,-2207,1,0.3225503698510217,0
2209,4418,-2209,1,0.993631065590017,0
2211,4422,-2211,1,0.7452452137569298,0
2212,4424,-2212,1,0.43471975960892795,0
2213,4426,-2213,1,0.6479685639416902,0
2214,4428,-2214,1,0.14373531561061692,0
2215,4430,-2215,1,0.345095643368475,0
2217,4434,-2217,1,0.9553257287136193,0
2218,4436,-2218,1,0.5742348331108376,0
2219,4438,-2219,1,0.8807084168552911,0
2222,4444,-2222,1,0.7483695480121897,0
2223,4446,-2223,1,0.7580931644921003,0
2226,4452,-2226,1,0.5103707422117281,0
2227,4454,-2227,1,0.4069858406308374,0
2228,4456,-2228,1,0.004579381958079054,0
2229,4458,-2229,1,0.8831869922899164,0
2230,4460,-2230,1,0.004412900657473018,0
2231,4462,-2231,1,0.7301057185290233,0
2232,4464,-2232,1,0.4093536105682708,0
2233,4466,-2233,1,0.8265211157916956,0
2234,4468,-2234,1,0.15452469567828597,0
2235,4470,-2235,1,0.3731771228270523,0
2236,4472,-2236,1,0.9665349490202942,0
2238,4476,-2238,1,0.10161728898881262,0
2239,4478,-2239,1,0.637200192181199,0
2240,4480,-2240,1,0.2387846209042067,0
2241,4482,-2241,1,0.7880409587570228,0
2242,4484,-2242,1,0.7407080356569067,0
2243,4486,-2243,1,0.32237172836714667,0
2245,4490,-2245,1,0.4163511085534668,0
2246,4492,-2246,1,0.5085835401103161,0
2247,4494,-2247,1,0.8007253819062249,0
2251,4502,-2251,1,0.2769207312299268,0
2252,4504,-2252,1,0.9302381685477451,0
2253,4506,-2253,1,0.02572572580006327,0
2254,4508,-2254,1,0.015565923091670597,0
2256,4512,-2256,1,0.9378699558323641,0
2257,4514,-2257,1,0.5260260461402156,0
2258,4516,-2258,1,0.7686199008204855,0
2260,4520,-2260,1,0.5204630343593304,0
2261,4522,-2261,1,0.46946043165842666,0
2262,4524,-2262,1,0.9253928260085156,0
2264,4528,-2264,1,0.8076674953125502,0
2265,4530,-2265,1,0.06453741409711977,0
2266,4532,-2266,1,0.2520767262656587,0
2267,4534,-2267,1,0.07521374932533986,0
2268,4536,-2268,1,0.9681259135562923,0
2269,4538,-2269,1,0.0678715460222219,0
2271,4542,-2271,1,0.7898590674724855,0
2272,4544,-2272,1,0.37527093203134143,0
2274,4548,-2274,1,0.29050986947729596,0
2275,4550,-2275,1,0.7256037294196651,0
2280,4560,-2280,1,0.5273382328817018,0
2283,4566,-2283,1,0.046818016548608066,0
2284,4568,-2284,1,0.4278163470679922,0
2287,4574,-2287,1,0.7127882991602988,0
2288,4576,-2288,1,0.7402513217493317,0
2289,4578,-2289,1,0.031214412493840826,0
2290,4580,-2290,1,0.3891187751196419,0
2291,4582,-2291,1,0.12869927254023006,0
2292,4584,-2292,1,0.32852305101916324,0
2294,4588,-2294,1,0.788266612037115,0
2296,4592,-2296,1,0.6330947478456019,0
2298,4596,-2298,1,0.6739838588577818,0
2299,4598,-2299,1,0.20817070053923992,0
2300,4600,-2300,1,0.8943901203997318,0
2301,4602,-2301,1,0.5884284016624949,0
2302,4604,-2302,1,0.2569503227947041,0
2303,4606,-2303,1,0.6352140446536979,0
2304,4608,-2304,1,0.5980318507399721,0
2305,4610,-2305,1,0.1980069932252868,0
2306,4612,-2306,1,0.7004560693377205,0
2307,4614,-2307,1,0.13524820404824311,0
2308,4616,-2308,1,0.6362678014207208,0
2309,4618,-2309,1,0.7214342128494557,0
2310,4620,-2310,1,0.26758383246852346,0
2311,4622,-2311,1,0.38135476262220636,0
2312,4624,-2312,1,0.31940633378385885,0
2313,4626,-2313,1,0.19083749019780694,0
2314,4628,-2314,1,0.07677070636607175,0
2315,4630,-2315,1,0.1469416408944838,0
2317,4634,-2317,1,0.35805287862838175,0
2318,4636,-2318,1,0.5666169624141,0
2320,4640,-2320,1,0.7885233838111272,0
2322,4644,-2322,1,0.13564477503085193,0
2323,4646,-2323,1,0.8252010086862245,0
2325,4650,-2325,1,0.7128671112164363,0
2327,4654,-2327,1,0.615756572027681,0
2329,4658,-2329,1,0.8918336142576953,0
2332,4664,-2332,1,0.8698814719796006,0
2333,4666,-2333,1,0.028522010684065013,0
2334,4668,-2334,1,0.8253392605203356,0
2335,4670,-2335,1,0.02207432111793095,0
2336,4672,-2336,1,0.7147129824327207,0
2337,4674,-2337,1,0.25282596130379165,0
2338,4676,-2338,1,0.22610089239864317,0
2339,4678,-2339,1,0.8510856113264925,0
2341,4682,-2341,1,0.37685060143538485,0
2343,4686,-2343,1,0.7887877019412051,0
2344,4688,-2344,1,0.4260987065916587,0
2345,4690,-2345,1,0.6464602545360952,0
2347,4694,-2347,1,0.9440061137628899,0
2348,4696,-2348,1,0.9280980457813708,0
2349,4698,-2349,1,0.05355618300913878,0
2350,4700,-2350,1,0.8937273056203178,0
2351,4702,-2351,1,0.44195685300565657,0
2352,4704,-2352,1,0.9233854403973801,0
2354,4708,-2354,1,0.8102120653853699,0
2355,4710,-2355,1,0.966870317254575,0
2356,4712,-2356,1,0.6960232218383842,0
2363,4726,-2363,1,0.9087802574143671,0
2366,4732,-2366,1,0.41165346874900066,0
2367,4734,-2367,1,0.9874044530069174,0
2373,4746,-2373,1,0.32588121381665003,0
2374,4748,-2374,1,0.10060764829449398,0
2375,4750,-2375,1,0.8057483570939699,0
2376,4752,-2376,1,0.7267869098739146,0
2378,4756,-2378,1,0.6969646464652206,0
2379,4758,-2379,1,0.956419899363113,0
2381,4762,-2381,1,0.7903819926514188,0
2382,4764,-2382,1,0.4327675236936639,0
2383,4766,-2383,1,0.4449747508346449,0
2384,4768,-2384,1,0.7805732461307561,0
2385,4770,-2385,1,0.18073698465501276,0
2386,4772,-2386,1,0.5352421896833753,0
2388,4776,-2388,1,0.7969190013517503,0
2389,4778,-2389,1,0.9584359302955512,0
2393,4786,-2393,1,0.04131887609754992,0
2395,4790,-2395,1,0.8150872717680728,0
2396,4792,-2396,1,0.34025470264726065,0
2397,4794,-2397,1,0.72865783119239,0
2398,4796,-2398,1,0.28718984986728,0
2399,4798,-2399,1,0.7890001969413373,0
2400,4800,-2400,1,0.26251665168498206,0
2401,4802,-2401,1,0.5844208045088181,0
2403,4806,-2403,1,0.9796326148211638,0
2405,4810,-2405,1,0.014623350569157534,0
2406,4812,-2406,1,0.39389547378406986,0
2408,4816,-2408,1,0.7889820221884132,0
2409,4818,-2409,1,0.4953388891789394,0
2411,4822,-2411,1,0.9242872411340157,0
2414,4828,-2414,1,0.7935429354805325,0
2416,4832,-2416,1,0.4415285864457391,0
2417,4834,-2417,1,0.2071674448863572,0
2418,4836,-2418,1,0.040594568719326984,0
2422,4844,-2422,1,0.15012788384507536,0
2423,4846,-2423,1,0.7817661386331374,0
2424,4848,-2424,1,0.5830273645393731,0
2425,4850,-2425,1,0.1131541232987483,0
2426,4852,-2426,1,0.8772704553240597,0
2428,4856,-2428,1,0.21780409804166,0
2429,4858,-2429,1,0.3359563789058272,0
2431,4862,-2431,1,0.6462754235418792,0
2432,4864,-2432,1,0.5752509461705435,0
2434,4868,-2434,1,0.9167647858845875,0
2435,4870,-2435,1,0.08281008358691466,0
2436,4872,-2436,1,0.22503218948714476,0
2437,4874,-2437,1,0.25465944762350656,0
2441,4882,-2441,1,0.672233545134885,0
2442,4884,-2442,1,0.8394846996430672,0
2443,4886,-2443,1,0.499637861137581,0
2444,4888,-2444,1,0.22536741817436967,0
2445,4890,-2445,1,0.34058954055150414,0
2446,4892,-2446,1,0.5792511156941419,0
2447,4894,-2447,1,0.7243775902745967,0
2448,4896,-2448,1,0.9779830065406819,0
2449,4898,-2449,1,0.659335779614311,0
2450,4900,-2450,1,0.9153566362301752,0
2451,4902,-2451,1,0.5826413438352236,0
2452,4904,-2452,1,0.608984152813816,0
2455,4910,-2455,1,0.1780914721645982,0
2456,4912,-2456,1,0.8256858519741461,0
2457,4914,-2457,1,0.958797959466436,0
2458,4916,-2458,1,0.14175805438859146,0
2459,4918,-2459,1,0.7419544605961552,0
2460,4920,-2460,1,0.2705639108022303,0
2461,4922,-2461,1,0.22374091055463374,0
2462,4924,-2462,1,0.49766145033235587,0
2463,4926,-2463,1,0.817692919587049,0
2467,4934,-2467,1,0.013498484080247564,0
2468,4936,-2468,1,0.6804637920815162,0
2469,4938,-2469,1,0.8447538407338996,0
2470,4940,-2470,1,0.32857637373525095,0
2473,4946,-2473,1,0.3160305007300871,0
2474,4948,-2474,1,0.25578318492394425,0
2477,4954,-2477,1,0.4856610671243433,0
2478,4956,-2478,1,0.4664334020511577,0
2480,4960,-2480,1,0.8427502807039187,0
2481,4962,-2481,1,0.06748622711992203,0
2482,4964,-2482,1,0.1758101393810798,0
2484,4968,-2484,1,0.37270128536186986,0
2485,4970,-2485,1,0.5131577859007704,0
2486,4972,-2486,1,0.6317872673519821,0
2487,4974,-2487,1,0.09504631444170408,0
2488,4976,-2488,1,0.5232378439430164,0
2489,4978,-2489,1,0.16358587321998885,0
2490,4980,-2490,1,0.11162981969783425,0
2491,4982,-2491,1,0.16809110501314795,0
2493,4986,-2493,1,0.7576483075712118,0
2495,4990,-2495,1,0.5776758367851458,0
2497,4994,-2497,1,0.420947078664751,0
2498,4996,-2498,1,0.44079810123195207,0
2499,4998,-2499,1,0.035328272602406896,0
2503,5006,-2503,1,0.01764126110305264,0
2504,5008,-2504,1,0.16993318878683605,0
2506,5012,-2506,1,0.02369713897885717,0
2509,5018,-2509,1,0.7545840306951249,0
2513,5026,-2513,1,0.13632150594680392,0
2516,5032,-2516,1,0.29983878014208054,0
2517,5034,-2517,1,0.08904878892042656,0
2518,5036,-2518,1,0.2125597049857484,0
2521,5042,-2521,1,0.7826802427614296,0
2522,5044,-2522,1,0.36018352834746725,0
2523,5046,-2523,1,0.004765302438849317,0
2524,5048,-2524,1,0.9227477456696596,0
2525,5050,-2525,1,0.20930592576492613,0
2526,5052,-2526,1,0.5355276265034491,0
2528,5056,-2528,1,0.7953447998250442,0
2529,5058,-2529,1,0.8751431168587764,0
2530,5060,-2530,1,0.6219402887997225,0
2531,5062,-2531,1,0.7757795267508198,0
2534,5068,-2534,1,0.6244108581334614,0
2535,5070,-2535,1,0.03288786928925036,0
2538,5076,-2538,1,0.2676228140166943,0
2540,5080,-2540,1,0.36763045301213204,0
2544,5088,-2544,1,0.8718687477054752,0
2545,5090,-2545,1,0.28118327722398284,0
2546,5092,-2546,1,0.23139635007273962,0
2547,5094,-2547,1,0.1516337848135294,0
2548,5096,-2548,1,0.04918186573723138,0
2549,5098,-2549,1,0.27257509911932143,0
2550,5100,-2550,1,0.22915165376448887,0
2551,5102,-2551,1,0.49757394431562296,0
2552,5104,-2552,1,0.2917589114179302,0
2553,5106,-2553,1,0.2740921552455492,0
2555,5110,-2555,1,0.18766379861083105,0
2556,5112,-2556,1,0.028129945034682913,0
2558,5116,-2558,1,0.8433074227472943,0
2559,5118,-2559,1,0.1255323765677575,0
2560,5120,-2560,1,0.5412095034062827,0
2561,5122,-2561,1,0.6765907303243648,0
2562,5124,-2562,1,0.4458646297706079,0
2564,5128,-2564,1,0.18464885635936834,0
2565,5130,-2565,1,0.7475301102468261,0
2566,5132,-2566,1,0.27191176144150875,0
2568,5136,-2568,1,0.11385802391759403,0
2571,5142,-2571,1,0.5103103922286207,0
2572,5144,-2572,1,0.7639834703957952,0
2573,5146,-2573,1,0.7665332563641608,0
2574,5148,-2574,1,0.1291357057630138,0
2575,5150,-2575,1,0.9963765562055786,0
2576,5152,-2576,1,0.6593404289801246,0
2577,5154,-2577,1,0.00669456711503047,0
2582,5164,-2582,1,0.6558989169269486,0
2585,5170,-2585,1,0.9647872218047921,0
2586,5172,-2586,1,0.27095000144252124,0
2588,5176,-2588,1,0.42276869923417915,0
2589,5178,-2589,1,0.41904230246594965,0
2594,5188,-2594,1,0.050210265719018765,0
2596,5192,-2596,1,0.1260980826900503,0
2600,5200,-2600,1,0.08348644450738374,0
2601,5202,-2601,1,0.08180413803859965,0
2603,5206,-2603,1,0.6435820770809002,0
2604,5208,-2604,1,0.9434062860360155,0
2605,5210,-2605,1,0.1438972707239602,0
2606,5212,-2606,1,0.08894902653293624,0
2607,5214,-2607,1,0.821468383386199,0
2608,5216,-2608,1,0.7549109313017754,0
2610,5220,-2610,1,0.5858737535594511,0
2611,5222,-2611,1,0.44311282459464263,0
2612,5224,-2612,1,0.30454505052005854,0
2613,5226,-2613,1,0.37668869947623895,0
2614,5228,-2614,1,0.37122586453843,0
2615,5230,-2615,1,0.08862739191957003,0
2616,5232,-2616,1,0.01508714105994402,0
2617,5234,-2617,1,0.5984144347790925,0
2619,5238,-2619,1,0.8564376181627891,0
2621,5242,-2621,1,0.41290451243793025,0
2624,5248,-2624,1,0.7711309147589421,0
2626,5252,-2626,1,0.3820263319256396,0
2627,5254,-2627,1,0.5009885849736646,0
2629,5258,-2629,1,0.7230975140526789,0
2631,5262,-2631,1,0.1603356400497259,0
2633,5266,-2633,1,0.5601809338451639,0
2634,5268,-2634,1,0.263643263013688,0
2635,5270,-2635,1,0.1968116393280297,0
2636,5272,-2636,1,0.12618950642539928,0
2637,5274,-2637,1,0.2773903994117619,0
2638,5276,-2638,1,0.631546798733121,0
2639,5278,-2639,1,0.3150417635890893,0
2640,5280,-2640,1,0.17628134508204807,0
2641,5282,-2641,1,0.8497042712458207,0
2642,5284,-2642,1,0.6758079306963645,0
2644,5288,-2644,1,0.4488559283164706,0
2645,5290,-2645,1,0.4816922460515237,0
2646,5292,-2646,1,0.15282488823142282,0
2647,5294,-2647,1,0.9700277537053239,0
2648,5296,-2648,1,0.021577942203004796,0
2649,5298,-2649,1,0.36742128416986175,0
2650,5300,-2650,1,0.743339402262433,0
2651,5302,-2651,1,0.3830421169246748,0
2652,5304,-2652,1,0.5939911843168364,0
2654,5308,-2654,1,0.564018491458649,0
2657,5314,-2657,1,0.34683746631168466,0
2659,5318,-2659,1,0.9632331529375067,0
2662,5324,-2662,1,0.4108994062385991,0
2664,5328,-2664,1,0.25957817744609457,0
2665,5330,-2665,1,0.755150510566158,0
2666,5332,-2666,1,0.23011260951593338,0
2667,5334,-2667,1,0.8576050131324192,0
2668,5336,-2668,1,0.5118244672824485,0
2669,5338,-2669,1,0.08796259946326057,0
2670,5340,-2670,1,0.9995953710971924,0
2671,5342,-2671,1,0.4831091187561811,0
2672,5344,-2672,1,0.25348511595275025,0
2675,5350,-2675,1,0.1365295723068639,0
2676,5352,-2676,1,0.2559401986692812,0
2677,5354,-2677,1,0.6603699446913548,0
2679,5358,-2679,1,0.6919763930290055,0
2681,5362,-2681,1,0.547335182424935,0
2682,5364,-2682,1,0.35563339921316517,0
2684,5368,-2684,1,0.06529422145656405,0
2685,5370,-2685,1,0.9209289274704051,0
2687,5374,-2687,1,0.29076454563566445,0
2688,5376,-2688,1,0.32782223737232474,0
2689,5378,-2689,1,0.3828355046516265,0
2690,5380,-2690,1,0.16405822918701352,0
2691,5382,-2691,1,0.7150245090605952,0
2692,5384,-2692,1,0.08084627996231275,0
2693,5386,-2693,1,0.32273520994823723,0
2694,5388,-2694,1,0.4587098871926276,0
2696,5392,-2696,1,0.7481547266584884,0
2699,5398,-2699,1,0.31699926340422957,0
2700,5400,-2700,1,0.0968495666451702,0
2701,5402,-2701,1,0.9135732470303263,0
2703,5406,-2703,1,0.7426679542123453,0
2705,5410,-2705,1,0.7414063229555726,0
2706,5412,-2706,1,0.40348973953532064,0
2708,5416,-2708,1,0.36722205515086825,0
2709,5418,-2709,1,0.8394120997203949,0
2710,5420,-2710,1,0.10602278884750838,0
2711,5422,-2711,1,0.8445142961423324,0
2713,5426,-2713,1,0.31263828866099974,0
2714,5428,-2714,1,0.9683226582816591,0
2717,5434,-2717,1,0.38999125211446206,0
2718,5436,-2718,1,0.807756929748349,0
2720,5440,-2720,1,0.4171663895323572,0
2723,5446,-2723,1,0.6960445537531479,0
2725,5450,-2725,1,0.43244818906257065,0
2727,5454,-2727,1,0.8367585365144482,0
2729,5458,-2729,1,0.9060469743681527,0
2730,5460,-2730,1,0.25849615652142655,0
2731,5462,-2731,1,0.6987210329151665,0
2732,5464,-2732,1,0.05193539073121922,0
2733,5466,-2733,1,0.37905411575460524,0
2734,5468,-2734,1,0.24128240554480995,0
2735,5470,-2735,1,0.9914144017298204,0
2736,5472,-2736,1,0.3372508374353821,0
2737,5474,-2737,1,0.9463480195699735,0
2739,5478,-2739,1,0.9890537309995547,0
2740,5480,-2740,1,0.6142136622531804,0
2741,5482,-2741,1,0.5115260051088716,0
2742,5484,-2742,1,0.21594077347655605,0
2743,5486,-2743,1,0.8840522328202047,0
2745,5490,-2745,1,0.03261273890752803,0
2746,5492,-2746,1,0.9949671181239136,0
2747,5494,-2747,1,0.5738133085523538,0
2748,5496,-2748,1,0.5283352427098207,0
2749,5498,-2749,1,0.8787035094749795,0
2750,5500,-2750,1,0.28784712054717476,0
2751,5502,-2751,1,0.2647718863505102,0
2752,5504,-2752,1,0.3171965137298527,0
2753,5506,-2753,1,0.3979270249595446,0
2754,5508,-2754,1,0.7613451456567978,0
2756,5512,-2756,1,0.4066529085666255,0
2757,5514,-2757,1,0.12301195268686038,0
2759,5518,-2759,1,0.7596125013380114,0
2761,5522,-2761,1,0.6600271134071249,0
2765,5530,-2765,1,0.80339870168728,0
2766,5532,-2766,1,0.41464464564164627,0
2768,5536,-2768,1,0.6111383791272104,0
2772,5544,-2772,1,0.7474553360685107,0
2773,5546,-2773,1,0.03095561262601121,0
2774,5548,-2774,1,0.7437827213338075,0
2775,5550,-2775,1,0.10025547752373654,0
2777,5554,-2777,1,0.9862668680462301,0
2778,5556,-2778,1,0.3214214564603567,0
2779,5558,-2779,1,0.6111143338695579,0
2780,5560,-2780,1,0.8014821208478881,0
2783,5566,-2783,1,0.4517792446375153,0
2784,5568,-2784,1,0.3548673608871533,0
2785,5570,-2785,1,0.409556191666255,0
2787,5574,-2787,1,0.12730628528257115,0
2789,5578,-2789,1,0.015586595230668743,0
2791,5582,-2791,1,0.7616270403355149,0
2792,5584,-2792,1,0.19278892998870767,0
2794,5588,-2794,1,0.005731924830010504,0
2795,5590,-2795,1,0.5300705763998436,0
2798,5596,-2798,1,0.1625467239554893,0
2800,5600,-2800,1,0.7527941961162169,0
2801,5602,-2801,1,0.29117863735725236,0
2802,5604,-2802,1,0.9337412338530304,0
2804,5608,-2804,1,0.024950877652576975,0
2805,5610,-2805,1,0.5392108372525015,0
2807,5614,-2807,1,0.9675367797076632,0
2808,5616,-2808,1,0.9125101782644087,0
2810,5620,-2810,1,0.16541297681855482,0
2811,5622,-2811,1,0.12246195156382711,0
2813,5626,-2813,1,0.2967199482110814,0
2814,5628,-2814,1,0.9505309491529332,0
2816,5632,-2816,1,0.25664646952807213,0
2817,5634,-2817,1,0.2726607438669665,0
2818,5636,-2818,1,0.9242533558300353,0
2820,5640,-2820,1,0.29925221984058625,0
2821,5642,-2821,1,0.20401372906804205,0
2824,5648,-2824,1,0.5263302026235945,0
2825,5650,-2825,1,0.583592913563869,0
2826,5652,-2826,1,0.49172778847898213,0
2827,5654,-2827,1,0.45360918289714547,0
2828,5656,-2828,1,0.9466161242152838,0
2829,5658,-2829,1,0.8035561870615302,0
2830,5660,-2830,1,0.4343880284503654,0
2831,5662,-2831,1,0.6059060035881259,0
2832,5664,-2832,1,0.3271914816064482,0
2833,5666,-2833,1,0.7647459106033981,0
2834,5668,-2834,1,0.6231468580770236,0
2837,5674,-2837,1,0.35886005074058824,0
2839,5678,-2839,1,0.2554125215779659,0
2840,5680,-2840,1,0.3798064222062534,0
2843,5686,-2843,1,0.10937637002369982,0
2844,5688,-2844,1,0.6875846069190521,0
2845,5690,-2845,1,0.13393023421451233,0
2847,5694,-2847,1,0.3393957589595905,0
2849,5698,-2849,1,0.3596377202430191,0
2850,5700,-2850,1,0.31256926029400545,0
2851,5702,-2851,1,0.5418291083871036,0
2853,5706,-2853,1,0.3735154482012699,0
2855,5710,-2855,1,0.8150677080649087,0
2857,5714,-2857,1,0.8930627493762472,0
2858,5716,-2858,1,0.2000334001923615,0
2861,5722,-2861,1,0.6577302470894866,0
2864,5728,-2864,1,0.3277896318478789,0
2865,5730,-2865,1,0.10456841410295459,0
2866,5732,-2866,1,0.1614870916220179,0
2867,5734,-2867,1,0.43611547888429103,0
2868,5736,-2868,1,0.8419928135364196,0
2869,5738,-2869,1,0.33486151794447316,0
2870,5740,-2870,1,0.5543007689239469,0
2871,5742,-2871,1,0.5801719329941741,0
2872,5744,-2872,1,0.4247429103937794,0
2873,5746,-2873,1,0.30778348601264083,0
2874,5748,-2874,1,0.480228898894567,0
2875,5750,-2875,1,0.9196597990378559,0
2877,5754,-2877,1,0.3696991152361664,0
2879,5758,-2879,1,0.059076858428567136,0
2882,5764,-2882,1,0.4605306542998797,0
2884,5768,-2884,1,0.6363991363842454,0
2885,5770,-2885,1,0.8578687826808419,0
2886,5772,-2886,1,0.5069502992419807,0
2887,5774,-2887,1,0.2716288113693922,0
2889,5778,-2889,1,0.04246330314461111,0
2890,5780,-2890,1,0.4166269420300316,0
2892,5784,-2892,1,0.0815184354928068,0
2893,5786,-2893,1,0.6502079825580046,0
2895,5790,-2895,1,0.9736827232850227,0
2897,5794,-2897,1,0.28711560037954154,0
2900,5800,-2900,1,0.7341554158653373,0
2902,5804,-2902,1,0.6274743797914201,0
2903,5806,-2903,1,0.6485301688669994,0
2904,5808,-2904,1,0.028301896917842018,0
2907,5814,-2907,1,0.8541113531253312,0
2908,5816,-2908,1,0.9953300007861282,0
2910,5820,-2910,1,0.9497315142794324,0
2913,5826,-2913,1,0.5936892053562677,0
2914,5828,-2914,1,0.42370009066954195,0
2915,5830,-2915,1,0.06398585581558236,0
2916,5832,-2916,1,0.6025456908002649,0
2918,5836,-2918,1,0.06546066190033206,0
2919,5838,-2919,1,0.15434727329709552,0
2921,5842,-2921,1,0.03683164214850443,0
2922,5844,-2922,1,0.40034927611931115,0
2923,5846,-2923,1,0.6110991875047324,0
2924,5848,-2924,1,0.14344923395987463,0
2926,5852,-2926,1,0.9623282644287899,0
2927,5854,-2927,1,0.20688676591666133,0
2928,5856,-2928,1,0.43319200140347747,0
2929,5858,-2929,1,0.26873228104370184,0
2930,5860,-2930,1,0.4052724483718225,0
2931,5862,-2931,1,0.14441641971838026,0
2932,5864,-2932,1,0.19499638843025868,0
2933,5866,-2933,1,0.32962904818721084,0
2934,5868,-2934,1,0.38631417409993896,0
2936,5872,-2936,1,0.08880610246768705,0
2940,5880,-2940,1,0.5182530605498568,0
2942,5884,-2942,1,0.6153194061984487,0
2946,5892,-2946,1,0.9013782834741532,0
2947,5894,-2947,1,0.773108630171393,0
2948,5896,-2948,1,0.45856540638130305,0
2949,5898,-2949,1,0.876981306374521,0
2950,5900,-2950,1,0.8965937254911748,0
2956,5912,-2956,1,0.05926308201618813,0
2957,5914,-2957,1,0.09764254013190887,0
2958,5916,-2958,1,0.8706943126924211,0
2959,5918,-2959,1,0.22069047078919168,0
2963,5926,-2963,1,0.9137043881906196,0
2965,5930,-2965,1,0.07970985463305269,0
2967,5934,-2967,1,0.3711858298210914,0
2968,5936,-2968,1,0.8527997944052064,0
2971,5942,-2971,1,0.4609175784742653,0
2972,5944,-2972,1,0.005893446910575695,0
2973,5946,-2973,1,0.06120810583368441,0
2974,5948,-2974,1,0.8377822804623932,0
2976,5952,-2976,1,0.8885013307449083,0
2977,5954,-2977,1,0.26371524383003675,0
2979,5958,-2979,1,0.2405699931824673,0
2980,5960,-2980,1,0.9413272620743198,0
2981,5962,-2981,1,0.4066569936872645,0
2983,5966,-2983,1,0.42155562178860806,0
2984,5968,-2984,1,0.4895735476514197,0
2987,5974,-2987,1,0.18576483777912256,0
2988,5976,-2988,1,0.9383746748061085,0
2989,5978,-2989,1,0.11801604173666391,0
2990,5980,-2990,1,0.43012422710053955,0
2991,5982,-2991,1,0.7457010875464978,0
2992,5984,-2992,1,0.6031167972957026,0
2994,5988,-2994,1,0.6106484692127514,0
2997,5994,-2997,1,0.5167924351793866,0
2998,5996,-2998,1,0.8060462646546829,0
3001,6002,-3001,1,0.797788148491117,1
3003,6006,-3003,1,0.7308517760831217,1
3004,6008,-3004,1,0.49015164738264216,1
3005,6010,-3005,1,0.15619018083155423,1
3006,6012,-3006,1,0.8138636523570166,1
3007,6014,-3007,1,0.3412585129767931,1
3008,6016,-3008,1,0.6549995176684302,1
3009,6018,-3009,1,0.6116760029946086,1
3010,6020,-3010,1,0.2990255143730076,1
3011,6022,-3011,1,0.29723342960026,1
3012,6024,-3012,1,0.7626464209696668,1
3013,6026,-3013,1,0.14031190869465293,1
3014,6028,-3014,1,0.0007507145073668564,1
3015,6030,-3015,1,0.6046909180855415,1
3016,6032,-3016,1,0.0386621214717241,1
3018,6036,-3018,1,0.8865434220650271,1
3019,6038,-3019,1,0.49092710320121624,1
3020,6040,-3020,1,0.40792364579969753,1
3021,6042,-3021,1,0.9008724417132645,1
3022,6044,-3022,1,0.20004932121531094,1
3023,6046,-3023,1,0.7824750080283164,1
3025,6050,-3025,1,0.9466323053428088,1
3026,6052,-3026,1,0.4143902499469485,1
3027,6054,-3027,1,0.38158074526334007,1
3029,6058,-3029,1,0.8258953144992695,1
3030,6060,-3030,1,0.03763231024274538,1
3031,6062,-3031,1,0.8461565815421895,1
3033,6066,-3033,1,0.13724840488460377,1
3036,6072,-3036,1,0.47255782094269827,1
3037,6074,-3037,1,0.20477644400956474,1
3038,6076,-3038,1,0.7821558776132056,1
3040,6080,-3040,1,0.9602941952072999,1
3046,6092,-3046,1,0.5898906717178544,1
3047,6094,-3047,1,0.43800387099225657,1
3048,6096,-3048,1,0.8851269700380902,1
3049,6098,-3049,1,0.3590558575096706,1
3050,6100,-3050,1,0.2541403380442101,1
3052,6104,-3052,1,0.5585899715233679,1
3053,6106,-3053,1,0.04444084836558848,1
3054,6108,-3054,1,0.09414615083254652,1
3056,6112,-3056,1,0.18722352303476142,1
3057,6114,-3057,1,0.7606227532416324,1
3059,6118,-3059,1,0.7199521462751725,1
3060,6120,-3060,1,0.9750275106080155,1
3061,6122,-3061,1,0.6511360805739327,1
3063,6126,-3063,1,0.16531643008034413,1
3067,6134,-3067,1,0.704267620631714,1
3070,6140,-3070,1,0.5099376219952324,1
3073,6146,-3073,1,0.853229966255263,1
3074,6148,-3074,1,0.08072348411628694,1
3075,6150,-3075,1,0.24931532902870146,1
3078,6156,-3078,1,0.16268017119598022,1
3080,6160,-3080,1,0.4662373835903181,1
3081,6162,-3081,1,0.9173091527247076,1
3086,6172,-3086,1,0.9949722075327562,1
3088,6176,-3088,1,0.7657772745874862,1
3089,6178,-3089,1,0.7541034732877528,1
3091,6182,-3091,1,0.92238366460174,1
3093,6186,-3093,1,0.699382011196243,1
3094,6188,-3094,1,0.8722377447553538,1
3095,6190,-3095,1,0.3221038331835001,1
3096,6192,-3096,1,0.897854019563433,1
3097,6194,-3097,1,0.16751528016598272,1
3098,6196,-3098,1,0.9426633934436213,1
3100,6200,-3100,1,0.7734381572410396,1
3101,6202,-3101,1,0.04065834832445303,1
3103,6206,-3103,1,0.9545671090433665,1
3104,6208,-3104,1,0.4657321979608121,1
3105,6210,-3105,1,0.29982793878372105,1
3106,6212,-3106,1,0.5988815447030379,1
3109,6218,-3109,1,0.4201422829357674,1
3110,6220,-3110,1,0.5496497774346818,1
3111,6222,-3111,1,0.27346090236726417,1
3115,6230,-3115,1,0.6192971734148536,1
3118,6236,-3118,1,0.12761409767531284,1
3120,6240,-3120,1,0.6570787307542637,1
3123,6246,-3123,1,0.9685878747314466,1
3124,6248,-3124,1,0.6029705226540538,1
3125,6250,-3125,1,0.524135492758709,1
3126,6252,-3126,1,0.006268385326095305,1
3129,6258,-3129,1,0.3572172243466848,1
3130,6260,-3130,1,0.4593518746902855,1
3131,6262,-3131,1,0.7583680110935348,1
3132,6264,-3132,1,0.556760396596001,1
3134,6268,-3134,1,0.6545221464405976,1
3135,6270,-3135,1,0.05225691663946108,1
3136,6272,-3136,1,0.0983982248417371,1
3137,6274,-3137,1,0.7590385654226213,1
3138,6276,-3138,1,0.20858375357712755,1
3139,6278,-3139,1,0.0886532526158903,1
3141,6282,-3141,1,0.43935498073211654,1
3143,6286,-3143,1,0.11531352441772436,1
3144,6288,-3144,1,0.8557872041525614,1
3145,6290,-3145,1,0.9067054804652148,1
3146,6292,-3146,1,0.6752089488743098,1
3147,6294,-3147,1,0.7058376948718015,1
3149,6298,-3149,1,0.08493977158800259,1
3150,6300,-3150,1,0.44116858493101707,1
3151,6302,-3151,1,0.8735394358913077,1
3153,6306,-3153,1,0.8648445674958731,1
3154,6308,-3154,1,0.7207775582551441,1
3155,6310,-3155,1,0.8846525390654698,1
3156,6312,-3156,1,0.2705410004958436,1
3157,6314,-3157,1,0.12727183796752928,1
3159,6318,-3159,1,0.8943198317215338,1
3160,6320,-3160,1,0.24264239706844437,1
3161,6322,-3161,1,0.22795237816231517,1
3163,6326,-3163,1,0.9717345182152219,1
3164,6328,-3164,1,0.2237357944182362,1
3165,6330,-3165,1,0.4501783841857794,1
3170,6340,-3170,1,0.22742384623870926,1
3171,6342,-3171,1,0.09630975180032819,1
3172,6344,-3172,1,0.6543045901924788,1
3173,6346,-3173,1,0.9626824561984068,1
3177,6354,-3177,1,0.4261162815926197,1
3179,6358,-3179,1,0.9331228090266008,1
3180,6360,-3180,1,0.355071150446742,1
3181,6362,-3181,1,0.14767746082392808,1
3182,6364,-3182,1,0.39122616600184,1
3183,6366,-3183,1,0.8227287009529264,1
3184,6368,-3184,1,0.32310228931173535,1
3185,6370,-3185,1,0.39551394753192826,1
3186,6372,-3186,1,0.48274639520255525,1
3188,6376,-3188,1,0.10266934821862839,1
3189,6378,-3189,1,0.14833634296954123,1
3191,6382,-3191,1,0.33822359109756517,1
3192,6384,-3192,1,0.05652010927000073,1
3195,6390,-3195,1,0.41040703471076456,1
3197,6394,-3197,1,0.016464560212481993,1
3200,6400,-3200,1,0.33914153261223456,1
3201,6402,-3201,1,0.6773655590337775,1
3202,6404,-3202,1,0.0754044014404689,1
3203,6406,-3203,1,0.971378951855345,1
3204,6408,-3204,1,0.4044737084496304,1
3205,6410,-3205,1,0.026978144066322374,1
3206,6412,-3206,1,0.32523890112446674,1
3207,6414,-3207,1,0.20030875109362967,1
3208,6416,-3208,1,0.06785031343205672,1
3210,6420,-3210,1,0.8221157256783235,1
3214,6428,-3214,1,0.3569081535085822,1
3215,6430,-3215,1,0.14732314292877957,1
3216,6432,-3216,1,0.5578330349086328,1
3217,6434,-3217,1,0.19738285551853663,1
3218,6436,-3218,1,0.8196470501874197,1
3220,6440,-3220,1,0.8674970531209932,1
3221,6442,-3221,1,0.18918049113255175,1
3222,6444,-3222,1,0.436088454413033,1
3224,6448,-3224,1,0.451266805213445,1
3226,6452,-3226,1,0.30125200914789163,1
3227,6454,-3227,1,0.7342912594864794,1
3228,6456,-3228,1,0.15928512505383996,1
3229,6458,-3229,1,0.3779929706658539,1
3230,6460,-3230,1,0.4075373075905302,1
3232,6464,-3232,1,0.20580553514931732,1
3233,6466,-3233,1,0.5243103606529028,1
3234,6468,-3234,1,0.05512722561004835,1
3235,6470,-3235,1,0.08213806659560607,1
3236,6472,-3236,1,0.607928697912193,1
3237,6474,-3237,1,0.9972222700765752,1
3239,6478,-3239,1,0.7324515513719079,1
3240,6480,-3240,1,0.7815963666693692,1
3242,6484,-3242,1,0.3300049234906691,1
3243,6486,-3243,1,0.08145022614365227,1
3244,6488,-3244,1,0.22274425007483545,1
3245,6490,-3245,1,0.7561763306537753,1
3246,6492,-3246,1,0.3120333602733515,1
3248,6496,-3248,1,0.21705723596945092,1
3250,6500,-3250,1,0.8395481429845785,1
3253,6506,-3253,1,0.991236987260173,1
3254,6508,-3254,1,0.5291603076274896,1
3255,6510,-3255,1,0.09575550012022893,1
3256,6512,-3256,1,0.9135344793613419,1
3260,6520,-3260,1,0.02408180185419262,1
3261,6522,-3261,1,0.6856944410218623,1
3264,6528,-3264,1,0.8277832405910107,1
3265,6530,-3265,1,0.0008434428594840115,1
3270,6540,-3270,1,0.32239302934213687,1
3271,6542,-3271,1,0.4693541456570719,1
3272,6544,-3272,1,0.7028875940007487,1
3275,6550,-3275,1,0.7079545606205474,1
3277,6554,-3277,1,0.02785841737523509,1
3278,6556,-3278,1,0.9103838037244428,1
3281,6562,-3281,1,0.22344177459656822,1
3282,6564,-3282,1,0.1964642401150738,1
3286,6572,-3286,1,0.6806352099810756,1
3287,6574,-3287,1,0.545350272234878,1
3289,6578,-3289,1,0.004807274805317618,1
3290,6580,-3290,1,0.4668269218098484,1
3291,6582,-3291,1,0.05099326596854514,1
3293,6586,-3293,1,0.5458311493612801,1
3294,6588,-3294,1,0.3368647531958886,1
3295,6590,-3295,1,0.6803619716345329,1
3296,6592,-3296,1,0.26038762464806275,1
3297,6594,-3297,1,0.2459120889830585,1
3299,6598,-3299,1,0.5208736318209191,1
3301,6602,-3301,1,0.10284127837256685,1
3302,6604,-3302,1,0.09544718628498972,1
3303,6606,-3303,1,0.1840035100617391,1
3304,6608,-3304,1,0.6819967334873315,1
3305,6610,-3305,1,0.6560858465126493,1
3306,6612,-3306,1,0.898673256608889,1
3307,6614,-3307,1,0.9302847226227954,1
3309,6618,-3309,1,0.9639635907715837,1
3311,6622,-3311,1,0.7564748165004073,1
3313,6626,-3313,1,0.7532892827732017,1
3314,6628,-3314,1,0.6998310730852649,1
3315,6630,-3315,1,0.49794011985415054,1
3317,6634,-3317,1,0.4648969289837678,1
3320,6640,-3320,1,0.39137512975602795,1
3321,6642,-3321,1,0.49619711952585166,1
3323,6646,-3323,1,0.0013450307967380892,1
3328,6656,-3328,1,0.7381326675548563,1
3330,6660,-3330,1,0.07103487854573964,1
3331,6662,-3331,1,0.6433463309026425,1
3332,6664,-3332,1,0.6622662227089877,1
3333,6666,-3333,1,0.975533671032919,1
3334,6668,-3334,1,0.18659236736371476,1
3335,6670,-3335,1,0.5717529052210707,1
3336,6672,-3336,1,0.6278813063742222,1
3337,6674,-3337,1,0.23204097257523626,1
3338,6676,-3338,1,0.09314676949388412,1
3339,6678,-3339,1,0.3001747389731556,1
3341,6682,-3341,1,0.3663549191856288,1
3342,6684,-3342,1,0.06699295900915203,1
3343,6686,-3343,1,0.40628304094214773,1
3345,6690,-3345,1,0.3290841277743628,1
3346,6692,-3346,1,0.5266545600702085,1
3349,6698,-3349,1,0.683385587296501,1
3350,6700,-3350,1,0.37727141955828425,1
3351,6702,-3351,1,0.976394570776445,1
3352,6704,-3352,1,0.06288498561842415,1
3353,6706,-3353,1,0.31105421345536943,1
3354,6708,-3354,1,0.8621742243798624,1
3355,6710,-3355,1,0.6274929035744344,1
3356,6712,-3356,1,0.35852417830776484,1
3357,6714,-3357,1,0.5885585239853346,1
3361,6722,-3361,1,0.91440730440959,1
3362,6724,-3362,1,0.8109506116870815,1
3363,6726,-3363,1,0.0274809988170559,1
3364,6728,-3364,1,0.18921483687727603,1
3365,6730,-3365,1,0.4588065127919244,1
3366,6732,-3366,1,0.39965310993920855,1
3367,6734,-3367,1,0.6980798302937428,1
3368,6736,-3368,1,0.07990280789586623,1
3369,6738,-3369,1,0.41538119236964843,1
3370,6740,-3370,1,0.8107417647092723,1
3373,6746,-3373,1,0.15111562742187257,1
3374,6748,-3374,1,0.14245049551685307,1
3375,6750,-3375,1,0.1983832270445509,1
3376,6752,-3376,1,0.805573849789134,1
3378,6756,-3378,1,0.816649131339087,1
3380,6760,-3380,1,0.7611285456188827,1
3381,6762,-3381,1,0.20171604848296554,1
3382,6764,-3382,1,0.4215290217059078,1
3383,6766,-3383,1,0.9693213719040016,1
3384,6768,-3384,1,0.6858696742124641,1
3385,6770,-3385,1,0.5990041818555076,1
3386,6772,-3386,1,0.5948495367375564,1
3388,6776,-3388,1,0.9793361599515237,1
3389,6778,-3389,1,0.7136169326937655,1
3392,6784,-3392,1,0.8125176564100638,1
3393,6786,-3393,1,0.511550192032276,1
3394,6788,-3394,1,0.2583510116199126,1
3396,6792,-3396,1,0.4696492767405017,1
3397,6794,-3397,1,0.6226410782153388,1
3400,6800,-3400,1,0.7190622973102729,1
3401,6802,-3401,1,0.27732440488100807,1
3402,6804,-3402,1,0.4440511691662383,1
3403,6806,-3403,1,0.2168639271957672,1
3404,6808,-3404,1,0.8423313808843702,1
3405,6810,-3405,1,0.2997158677151778,1
3406,6812,-3406,1,0.36668665114252286,1
3407,6814,-3407,1,0.6671283440961956,1
3409,6818,-3409,1,0.367367607718322,1
3410,6820,-3410,1,0.8902630999816091,1
3411,6822,-3411,1,0.975038223938089,1
3413,6826,-3413,1,0.025998704304183606,1
3414,6828,-3414,1,0.24572504524153038,1
3416,6832,-3416,1,0.12168145009499043,1
3417,6834,-3417,1,0.6027959509778866,1
3418,6836,-3418,1,0.2447035301331324,1
3419,6838,-3419,1,0.864216770241021,1
3421,6842,-3421,1,0.16095042847100527,1
3422,6844,-3422,1,0.4328146815820184,1
3423,6846,-3423,1,0.6683299144713938,1
3426,6852,-3426,1,0.543369501200685,1
3427,6854,-3427,1,0.4046247080545874,1
3431,6862,-3431,1,0.18508304665561082,1
3432,6864,-3432,1,0.7152978192003119,1
3434,6868,-3434,1,0.8720611168824325,1
3436,6872,-3436,1,0.6190818866260144,1
3437,6874,-3437,1,0.4675275564408995,1
3438,6876,-3438,1,0.14806314161486211,1
3441,6882,-3441,1,0.2118029118578817,1
3442,6884,-3442,1,0.2865187269085261,1
3443,6886,-3443,1,0.6021201933293195,1
3445,6890,-3445,1,0.019126532206776514,1
3448,6896,-3448,1,0.4281831284729316,1
3449,6898,-3449,1,0.3901650506255149,1
3450,6900,-3450,1,0.5904957204650474,1
3451,6902,-3451,1,0.3468764735846378,1
3452,6904,-3452,1,0.3504768195940786,1
3453,6906,-3453,1,0.05540107198988642,1
3454,6908,-3454,1,0.7302280548896223,1
3455,6910,-3455,1,0.34391192834323836,1
3457,6914,-3457,1,0.3664888872874864,1
3458,6916,-3458,1,0.25520178398572124,1
3459,6918,-3459,1,0.584611041156138,1
3460,6920,-3460,1,0.4589779295217721,1
3461,6922,-3461,1,0.2789734739923221,1
3464,6928,-3464,1,0.3148647676501618,1
3465,6930,-3465,1,0.17451942348557814,1
3466,6932,-3466,1,0.6173467795883306,1
3467,6934,-3467,1,0.26892810819740076,1
3468,6936,-3468,1,0.6255587801279706,1
3472,6944,-3472,1,0.8462302659137017,1
3474,6948,-3474,1,0.9460509627882489,1
3477,6954,-3477,1,0.2726083210241321,1
3478,6956,-3478,1,0.5354181042707553,1
3479,6958,-3479,1,0.36705451244040976,1
3485,6970,-3485,1,0.1042550355353481,1
3486,6972,-3486,1,0.5349096549251923,1
3487,6974,-3487,1,0.3428985042442567,1
3488,6976,-3488,1,0.8541927139315573,1
3489,6978,-3489,1,0.8145096947180754,1
3490,6980,-3490,1,0.8901864109170102,1
3491,6982,-3491,1,0.8331445067084855,1
3492,6984,-3492,1,0.5514594427371854,1
3494,6988,-3494,1,0.6629803103654456,1
3495,6990,-3495,1,0.9087958066894338,1
3496,6992,-3496,1,0.34828417147800816,1
3497,6994,-3497,1,0.3511659761087975,1
3499,6998,-3499,1,0.17152957753014597,1
3500,7000,-3500,1,0.844447640549889,1
3501,7002,-3501,1,0.46586533359176985,1
3503,7006,-3503,1,0.37451767431151195,1
3504,7008,-3504,1,0.46946817719948164,1
3507,7014,-3507,1,0.41681619070816955,1
3508,7016,-3508,1,0.5477725596824135,1
3510,7020,-3510,1,0.44452269766774277,1
3511,7022,-3511,1,0.49836443394754715,1
3513,7026,-3513,1,0.28383214356438347,1
3514,7028,-3514,1,0.9142947668796497,1
3515,7030,-3515,1,0.715258638603244,1
3516,7032,-3516,1,0.1364068886715546,1
3517,7034,-3517,1,0.6980036873596955,1
3520,7040,-3520,1,0.03735596957335563,1
3521,7042,-3521,1,0.4707268027100354,1
3522,7044,-3522,1,0.2918238704412197,1
3525,7050,-3525,1,0.5622469669691122,1
3528,7056,-3528,1,0.3149371601124593,1
3529,7058,-3529,1,0.16126079888429456,1
3530,7060,-3530,1,0.8414864006243712,1
3531,7062,-3531,1,0.25570477478403586,1
3532,7064,-3532,1,0.2671642554678134,1
3533,7066,-3533,1,0.9564487897773558,1
3534,7068,-3534,1,0.9021253896662094,1
3535,7070,-3535,1,0.14230654511676188,1
3536,7072,-3536,1,0.5837378642190821,1
3537,7074,-3537,1,0.8407803545793575,1
3539,7078,-3539,1,0.8713345002091647,1
3542,7084,-3542,1,0.01442031614996575,1
3544,7088,-3544,1,0.8375197434240054,1
3546,7092,-3546,1,0.02996666527258851,1
3548,7096,-3548,1,0.8386228179606415,1
3551,7102,-3551,1,0.9549673284715781,1
3553,7106,-3553,1,0.10252982991071036,1
3554,7108,-3554,1,0.5185574038809078,1
3555,7110,-3555,1,0.11836565651168429,1
3556,7112,-3556,1,0.0879681341669436,1
3557,7114,-3557,1,0.5013336383132811,1
3558,7116,-3558,1,0.7946171223829042,1
3560,7120,-3560,1,0.7794464022712385,1
3561,7122,-3561,1,0.2659003489118835,1
3562,7124,-3562,1,0.06402270468278937,1
3564,7128,-3564,1,0.3786843476570917,1
3565,7130,-3565,1,0.9063184920819221,1
3568,7136,-3568,1,0.5595593716563422,1
3570,7140,-3570,1,0.5813449960634954,1
3572,7144,-3572,1,0.515637318058676,1
3573,7146,-3573,1,0.1580608768644749,1
3575,7150,-3575,1,0.32348217061607576,1
3576,7152,-3576,1,0.838997997998551,1
3577,7154,-3577,1,0.8927009907771952,1
3578,7156,-3578,1,0.9457974553589508,1
3580,7160,-3580,1,0.6861129791120955,1
3582,7164,-3582,1,0.7227941879291868,1
3584,7168,-3584,1,0.17510140641013405,1
3587,7174,-3587,1,0.47721878847117094,1
3588,7176,-3588,1,0.6770774484110658,1
3589,7178,-3589,1,0.3019232744532212,1
3590,7180,-3590,1,0.24313177501834882,1
3591,7182,-3591,1,0.482607764479944,1
3593,7186,-3593,1,0.017942303569104534,1
3594,7188,-3594,1,0.2007234050526,1
3597,7194,-3597,1,0.2384466047882805,1
3598,7196,-3598,1,0.03161747475201582,1
3600,7200,-3600,1,0.3660390249246531,1
3601,7202,-3601,1,0.4820711797718985,1
3602,7204,-3602,1,0.5310468245210814,1
3603,7206,-3603,1,0.9298392359372246,1
3604,7208,-3604,1,0.31091626093544966,1
3605,7210,-3605,1,0.3656952281832767,1
3606,7212,-3606,1,0.48167730722831015,1
3607,7214,-3607,1,0.13988887058770783,1
3609,7218,-3609,1,0.9181400401115142,1
3611,7222,-3611,1,0.015081079854771584,1
3612,7224,-3612,1,0.9527058936094748,1
3613,7226,-3613,1,0.47503413291600405,1
3615,7230,-3615,1,0.4793141081664465,1
3616,7232,-3616,1,0.9286395765674182,1
3617,7234,-3617,1,0.15271408680742793,1
3618,7236,-3618,1,0.6657550190236632,1
3620,7240,-3620,1,0.8091749716453129,1
3621,7242,-3621,1,0.35986020958991305,1
3622,7244,-3622,1,0.024498450541871275,1
3623,7246,-3623,1,0.6910731301453152,1
3624,7248,-3624,1,0.937748639750417,1
3626,7252,-3626,1,0.5816884579500183,1
3628,7256,-3628,1,0.572866345490305,1
3630,7260,-3630,1,0.7400124753477241,1
3631,7262,-3631,1,0.6789225790122844,1
3632,7264,-3632,1,0.5244662195381892,1
3633,7266,-3633,1,0.6369127858685514,1
3635,7270,-3635,1,0.06821270880791386,1
3636,7272,-3636,1,0.8213945987101866,1
3637,7274,-3637,1,0.33706276904472665,1
3638,7276,-3638,1,0.5635279981823916,1
3639,7278,-3639,1,0.07047053275894188,1
3640,7280,-3640,1,0.3997245539803108,1
3642,7284,-3642,1,0.43614520905294485,1
3643,7286,-3643,1,0.17953700931342065,1
3644,7288,-3644,1,0.745244984518106,1
3645,7290,-3645,1,0.9318926318386722,1
3648,7296,-3648,1,0.7282254397231354,1
3649,7298,-3649,1,0.5335214377970623,1
3650,7300,-3650,1,0.436535642594997,1
3652,7304,-3652,1,0.8727326309048722,1
3655,7310,-3655,1,0.7917545622497784,1
3657,7314,-3657,1,0.708575146345859,1
3659,7318,-3659,1,0.5566322338783185,1
3662,7324,-3662,1,0.27014774444151335,1
3663,7326,-3663,1,0.20305074262353695,1
3664,7328,-3664,1,0.7195997430228553,1
3671,7342,-3671,1,0.7554158691108318,1
3672,7344,-3672,1,0.9818385200167763,1
3673,7346,-3673,1,0.141371196349952,1
3676,7352,-3676,1,0.7653179786994772,1
3677,7354,-3677,1,0.014696241716917302,1
3679,7358,-3679,1,0.7156387792454065,1
3681,7362,-3681,1,0.8022126240620957,1
3682,7364,-3682,1,0.9902307840554617,1
3684,7368,-3684,1,0.9869870626383909,1
3685,7370,-3685,1,0.7914023084216179,1
3686,7372,-3686,1,0.5764282070128817,1
3687,7374,-3687,1,0.9152008563928313,1
3688,7376,-3688,1,0.48986733652644165,1
3689,7378,-3689,1,0.9990703166493631,1
3690,7380,-3690,1,0.9662766535277539,1
3692,7384,-3692,1,0.38100280240952433,1
3693,7386,-3693,1,0.3782059674675762,1
3694,7388,-3694,1,0.4715485322274279,1
3695,7390,-3695,1,0.5158213183331712,1
3697,7394,-3697,1,0.5095287664225682,1
3698,7396,-3698,1,0.8924376552778704,1
3700,7400,-3700,1,0.8750929455842328,1
3702,7404,-3702,1,0.9785073874776749,1
3704,7408,-3704,1,0.3732111857310002,1
3707,7414,-3707,1,0.9420590531373684,1
3708,7416,-3708,1,0.45683700808421235,1
3709,7418,-3709,1,0.582883893334221,1
3710,7420,-3710,1,0.510070728235433,1
3711,7422,-3711,1,0.2761111737368497,1
3714,7428,-3714,1,0.5042194435421511,1
3715,7430,-3715,1,0.982783339420074,1
3716,7432,-3716,1,0.6694694916419711,1
3718,7436,-3718,1,0.8748160755483805,1
3719,7438,-3719,1,0.15486124281713964,1
3720,7440,-3720,1,0.1624614121874195,1
3721,7442,-3721,1,0.9393861876324142,1
3723,7446,-3723,1,0.9782308294100963,1
3725,7450,-3725,1,0.702159104018364,1
3726,7452,-3726,1,0.20510416116488261,1
3728,7456,-3728,1,0.3626062932221955,1
3729,7458,-3729,1,0.5653950899952879,1
3732,7464,-3732,1,0.09539464817863896,1
3738,7476,-3738,1,0.16824852679370206,1
3739,7478,-3739,1,0.709978880378364,1
3741,7482,-3741,1,0.6116294576645731,1
3742,7484,-3742,1,0.1413617247057808,1
3743,7486,-3743,1,0.09115368108803945,1
3744,7488,-3744,1,0.5182361247102727,1
3746,7492,-3746,1,0.3903416146840467,1
3748,7496,-3748,1,0.7078209171094023,1
3749,7498,-3749,1,0.7830307386445509,1
3750,7500,-3750,1,0.31986591056482194,1
3752,7504,-3752,1,0.10023463833246837,1
3754,7508,-3754,1,0.7686712612276727,1
3755,7510,-3755,1,0.35452318044119,1
3756,7512,-3756,1,0.21700757736104248,1
3760,7520,-3760,1,0.8969041978166774,1
3761,7522,-3761,1,0.959077192832277,1
3762,7524,-3762,1,0.15701685918610608,1
3763,7526,-3763,1,0.026489748036977234,1
3764,7528,-3764,1,0.6069085793417447,1
3765,7530,-3765,1,0.5877105465197886,1
3766,7532,-3766,1,0.2301059240991712,1
3769,7538,-3769,1,0.011810497568868206,1
3770,7540,-3770,1,0.6339385689304428,1
3771,7542,-3771,1,0.5048654654643281,1
3772,7544,-3772,1,0.13145348192799,1
3773,7546,-3773,1,0.5382248490510548,1
3774,7548,-3774,1,0.8814822206697175,1
3776,7552,-3776,1,0.964469068980433,1
3777,7554,-3777,1,0.4068139336610741,1
3781,7562,-3781,1,0.611273794217903,1
3782,7564,-3782,1,0.376166159201225,1
3784,7568,-3784,1,0.5762660359188954,1
3786,7572,-3786,1,0.701348995290159,1
3787,7574,-3787,1,0.4641725494912047,1
3789,7578,-3789,1,0.4023950875912532,1
3790,7580,-3790,1,0.4673310172455376,1
3792,7584,-3792,1,0.6771383149112463,1
3793,7586,-3793,1,0.8742325829457829,1
3794,7588,-3794,1,0.3543849757373112,1
3795,7590,-3795,1,0.8132510815029427,1
3796,7592,-3796,1,0.1914758431757314,1
3797,7594,-3797,1,0.9529331575576194,1
3799,7598,-3799,1,0.12830170068645386,1
3802,7604,-3802,1,0.7331516376660161,1
3803,7606,-3803,1,0.5428224246592808,1
3804,7608,-3804,1,0.3407461321050195,1
3805,7610,-3805,1,0.5984664927491695,1
3807,7614,-3807,1,0.2634601037142117,1
3809,7618,-3809,1,0.7086834492210201,1
3810,7620,-3810,1,0.5262044691923846,1
3811,7622,-3811,1,0.11216786854684968,1
3812,7624,-3812,1,0.3491424792430775,1
3815,7630,-3815,1,0.6499349669375625,1
3816,7632,-3816,1,0.8090684376234669,1
3818,7636,-3818,1,0.16404647521892624,1
3820,7640,-3820,1,0.25811144898886185,1
3822,7644,-3822,1,0.5067872850268736,1
3824,7648,-3824,1,0.9935394026372035,1
3825,7650,-3825,1,0.8562966913919419,1
3826,7652,-3826,1,0.11725432598210028,1
3828,7656,-3828,1,0.8763721436295415,1
3832,7664,-3832,1,0.0662411004612462,1
3833,7666,-3833,1,0.011076183968354303,1
3834,7668,-3834,1,0.34595578288019024,1
3835,7670,-3835,1,0.6539391869411925,1
3836,7672,-3836,1,0.5632926682819152,1
3837,7674,-3837,1,0.3012625704629901,1
3840,7680,-3840,1,0.8077624050407524,1
3841,7682,-3841,1,0.2753607313778751,1
3842,7684,-3842,1,0.10970739625116477,1
3843,7686,-3843,1,0.680928236003159,1
3844,7688,-3844,1,0.6408177119421197,1
3845,7690,-3845,1,0.4020165288370947,1
3846,7692,-3846,1,0.26371324351725867,1
3847,7694,-3847,1,0.49215694559501333,1
3849,7698,-3849,1,0.053590898984311686,1
3850,7700,-3850,1,0.7823452686675575,1
3851,7702,-3851,1,0.3908059184613518,1
3852,7704,-3852,1,0.42834965059581054,1
3853,7706,-3853,1,0.5416347386207676,1
3854,7708,-3854,1,0.7228764965314879,1
3855,7710,-3855,1,0.08921129520498672,1
3856,7712,-3856,1,0.9348788422912693,1
3858,7716,-3858,1,0.36334042095220886,1
3859,7718,-3859,1,0.7885384236717361,1
3860,7720,-3860,1,0.7970585157499689,1
3861,7722,-3861,1,0.12377413276041926,1
3862,7724,-3862,1,0.5699344306919966,1
3863,7726,-3863,1,0.8475397307538325,1
3865,7730,-3865,1,0.7406664331404923,1
3866,7732,-3866,1,0.1755512783571379,1
3868,7736,-3868,1,0.059521809658419245,1
3869,7738,-3869,1,0.9465448015337782,1
3870,7740,-3870,1,0.005306051746413187,1
3871,7742,-3871,1,0.36606017876969577,1
3872,7744,-3872,1,0.8415691572023057,1
3875,7750,-3875,1,0.1208922102994675,1
3876,7752,-3876,1,0.6316791270109545,1
3877,7754,-3877,1,0.6913667053979135,1
3878,7756,-3878,1,0.09984394392710405,1
3879,7758,-3879,1,0.8055906028411081,1
3881,7762,-3881,1,0.7079943773960907,1
3882,7764,-3882,1,0.6014541421373167,1
3883,7766,-3883,1,0.8109233840592664,1
3884,7768,-3884,1,0.6435183539211728,1
3885,7770,-3885,1,0.5172769450139236,1
3886,7772,-3886,1,0.5378861552796672,1
3887,7774,-3887,1,0.6987685762866209,1
3889,7778,-3889,1,0.10641036760325073,1
3891,7782,-3891,1,0.07507117355220583,1
3892,7784,-3892,1,0.8109829558519093,1
3893,7786,-3893,1,0.5022161703541586,1
3895,7790,-3895,1,0.5278793732709883,1
3897,7794,-3897,1,0.4291854230085792,1
3898,7796,-3898,1,0.40414754242801687,1
3900,7800,-3900,1,0.3687744232733702,1
3901,7802,-3901,1,0.026963870232294296,1
3905,7810,-3905,1,0.26116620197330487,1
3906,7812,-3906,1,0.33283020672899666,1
3909,7818,-3909,1,0.1666668946215919,1
3911,7822,-3911,1,0.9300509031184908,1
3912,7824,-3912,1,0.2314071345689196,1
3915,7830,-3915,1,0.23619742111624187,1
3916,7832,-3916,1,0.2752659136703549,1
3917,7834,-3917,1,0.9962092036498146,1
3918,7836,-3918,1,0.45656356640055007,1
3919,7838,-3919,1,0.08996363903955118,1
3920,7840,-3920,1,0.4252680992139848,1
3921,7842,-3921,1,0.3750427025804878,1
3922,7844,-3922,1,0.2535561229989801,1
3923,7846,-3923,1,0.23139030351579004,1
3924,7848,-3924,1,0.7990007291402965,1
3926,7852,-3926,1,0.7340338993544262,1
3927,7854,-3927,1,0.7887994251642616,1
3928,7856,-3928,1,0.8954453749191581,1
3930,7860,-3930,1,0.29337397053753533,1
3931,7862,-3931,1,0.6921507002855403,1
3932,7864,-3932,1,0.5823775200876784,1
3934,7868,-3934,1,0.8709877598210488,1
3936,7872,-3936,1,0.12465590086595624,1
3938,7876,-3938,1,0.46992106729076066,1
3939,7878,-3939,1,0.8799430201309116,1
3940,7880,-3940,1,0.698940243332105,1
3941,7882,-3941,1,0.1663997214984303,1
3942,7884,-3942,1,0.8134782666069101,1
3943,7886,-3943,1,0.31944536785192534,1
3944,7888,-3944,1,0.4094076605910363,1
3945,7890,-3945,1,0.24401140510821973,1
3947,7894,-3947,1,0.06418619075769483,1
3948,7896,-3948,1,0.24961857847372393,1
3949,7898,-3949,1,0.39459010374850334,1
3951,7902,-3951,1,0.8494994576994883,1
3953,7906,-3953,1,0.9970148446207909,1
3954,7908,-3954,1,0.6779048183242645,1
3956,7912,-3956,1,0.48776162859283023,1
3958,7916,-3958,1,0.6920450017210595,1
3959,7918,-3959,1,0.8031133163528478,1
3960,7920,-3960,1,0.8302449560603142,1
3961,7922,-3961,1,0.3277862257249523,1
3962,7924,-3962,1,0.9942597413647276,1
3963,7926,-3963,1,0.6275846222408226,1
3964,7928,-3964,1,0.4267291854384958,1
3966,7932,-3966,1,0.5784682146137411,1
3968,7936,-3968,1,0.7574133239523289,1
3970,7940,-3970,1,0.23733029445422726,1
3971,7942,-3971,1,0.4607811555349052,1
3972,7944,-3972,1,0.2541077895263948,1
3975,7950,-3975,1,0.8745316116192222,1
3979,7958,-3979,1,0.8501981334198709,1
3980,7960,-3980,1,0.713283558666583,1
3981,7962,-3981,1,0.21014821418786855,1
3982,7964,-3982,1,0.033251754833139247,1
3985,7970,-3985,1,0.6594132317243494,1
3987,7974,-3987,1,0.5288291342022896,1
3989,7978,-3989,1,0.4878231287100926,1
3990,7980,-3990,1,0.5396000487093281,1
3992,7984,-3992,1,0.8243215660164037,1
3994,7988,-3994,1,0.10642521590583087,1
3995,7990,-3995,1,0.5459771518342857,1
3996,7992,-3996,1,0.33494543069294225,1
3998,7996,-3998,1,0.7588738217850749,1
3999,7998,-3999,1,0.03841300061977915,1
4001,8002,-4001,1,0.03883015544034307,1
4004,8008,-4004,1,0.4449845415148591,1
4005,8010,-4005,1,0.5343529499349108,1
4006,8012,-4006,1,0.20419703753210028,1
4007,8014,-4007,1,0.6533660310483101,1
4008,8016,-4008,1,0.2604912923093201,1
4009,8018,-4009,1,0.854920439219953,1
4010,8020,-4010,1,0.829956184129217,1
4011,8022,-4011,1,0.5311246044550878,1
4012,8024,-4012,1,0.8260931745723553,1
4013,8026,-4013,1,0.718540236099462,1
4015,8030,-4015,1,0.19386492466116967,1
4017,8034,-4017,1,0.7760792575957012,1
4018,8036,-4018,1,0.9023874862385457,1
4019,8038,-4019,1,0.33037132890864684,1
4021,8042,-4021,1,0.955186225174218,1
4025,8050,-4025,1,0.49422559018352674,1
4026,8052,-4026,1,0.09152575116618034,1
4027,8054,-4027,1,0.8487508610650082,1
4029,8058,-4029,1,0.16122769093810463,1
4030,8060,-4030,1,0.007159792749524052,1
4032,8064,-4032,1,0.12190368163046938,1
4033,8066,-4033,1,0.17184885691096197,1
4034,8068,-4034,1,0.4001391289253856,1
4035,8070,-4035,1,0.14500359587375644,1
4036,8072,-4036,1,0.8090687640211376,1
4037,8074,-4037,1,0.028946741406696952,1
4038,8076,-4038,1,0.7489063455764722,1
4039,8078,-4039,1,0.6937667407738843,1
4040,8080,-4040,1,0.871249500418604,1
4042,8084,-4042,1,0.5880652820553741,1
4043,8086,-4043,1,0.9446522395220898,1
4044,8088,-4044,1,0.901246984912756,1
4045,8090,-4045,1,0.8013457717178248,1
4046,8092,-4046,1,0.029619723969770084,1
4047,8094,-4047,1,0.32389586362403966,1
4049,8098,-4049,1,0.5126778334422145,1
4053,8106,-4053,1,0.8408962418517353,1
4054,8108,-4054,1,0.35678845467335896,1
4055,8110,-4055,1,0.3893383783810864,1
4056,8112,-4056,1,0.5628455797073242,1
4057,8114,-4057,1,0.4731343704679778,1
4058,8116,-4058,1,0.9261620633315731,1
4059,8118,-4059,1,0.7827797432968833,1
4060,8120,-4060,1,0.8288497694242636,1
4061,8122,-4061,1,0.950190962640144,1
4062,8124,-4062,1,0.4292593408271821,1
4063,8126,-4063,1,0.9355747101102374,1
4064,8128,-4064,1,0.02332641094298249,1
4066,8132,-4066,1,0.44839119032301966,1
4067,8134,-4067,1,0.20366705783050842,1
4068,8136,-4068,1,0.1628319533180932,1
4069,8138,-4069,1,0.30576048835757197,1
4070,8140,-4070,1,0.6282160729800068,1
4073,8146,-4073,1,0.8354551276060527,1
4074,8148,-4074,1,0.7431249912164779,1
4075,8150,-4075,1,0.2020385297036934,1
4077,8154,-4077,1,0.7134676175518325,1
4079,8158,-4079,1,0.648954241621845,1
4080,8160,-4080,1,0.40607795993722984,1
4081,8162,-4081,1,0.11477564254982209,1
4082,8164,-4082,1,0.07841633696368311,1
4084,8168,-4084,1,0.41690904429543074,1
4085,8170,-4085,1,0.7665034993294555,1
4087,8174,-4087,1,0.9839622804088932,1
4088,8176,-4088,1,0.9585776576079119,1
4089,8178,-4089,1,0.31798669461154483,1
4090,8180,-4090,1,0.8151142124157574,1
4091,8182,-4091,1,0.9560749157080595,1
4093,8186,-4093,1,0.9091881408488474,1
4094,8188,-4094,1,0.5652845907189951,1
4095,8190,-4095,1,0.8557284910962728,1
4096,8192,-4096,1,0.8452802253613182,1
4097,8194,-4097,1,0.9043585556106325,1
4099,8198,-4099,1,0.5688457654561813,1
4100,8200,-4100,1,0.5541734048126996,1
4101,8202,-4101,1,0.5877468083991633,1
4104,8208,-4104,1,0.9875101355496179,1
4106,8212,-4106,1,0.19659512601911655,1
4111,8222,-4111,1,0.20306985501431007,1
4112,8224,-4112,1,0.2709966160556758,1
4113,8226,-4113,1,0.9870368222298233,1
4117,8234,-4117,1,0.26404140588568925,1
4119,8238,-4119,1,0.18057197625326438,1
4121,8242,-4121,1,0.07510148801561745,1
4123,8246,-4123,1,0.3429170780049554,1
4124,8248,-4124,1,0.5214311473075417,1
4126,8252,-4126,1,0.9556080580560307,1
4127,8254,-4127,1,0.42993177640438884,1
4130,8260,-4130,1,0.6457430756356508,1
4132,8264,-4132,1,0.4578109362039935,1
4133,8266,-4133,1,0.13251161823705915,1
4134,8268,-4134,1,0.2562882477726517,1
4137,8274,-4137,1,0.6411566306648876,1
4138,8276,-4138,1,0.6870466704106641,1
4140,8280,-4140,1,0.5863645899007843,1
4141,8282,-4141,1,0.2282904797596752,1
4144,8288,-4144,1,0.18394551839521933,1
4147,8294,-4147,1,0.005302588569347733,1
4148,8296,-4148,1,0.579336981838978,1
4149,8298,-4149,1,0.5676505536948832,1
4151,8302,-4151,1,0.3274155334815041,1
4153,8306,-4153,1,0.375353059134944,1
4154,8308,-4154,1,0.4689490130821423,1
4155,8310,-4155,1,0.8876091260309246,1
4158,8316,-4158,1,0.23484407911635252,1
4159,8318,-4159,1,0.012096280075239219,1
4160,8320,-4160,1,0.6506377063987715,1
4162,8324,-4162,1,0.9392145318275712,1
4163,8326,-4163,1,0.965725177122677,1
4164,8328,-4164,1,0.9082601785897976,1
4167,8334,-4167,1,0.7530416023517743,1
4168,8336,-4168,1,0.7908274914003005,1
4169,8338,-4169,1,0.9763597352940463,1
4171,8342,-4171,1,0.3746811299415298,1
4172,8344,-4172,1,0.7719192532064901,1
4173,8346,-4173,1,0.4328443883022739,1
4175,8350,-4175,1,0.9867974289504783,1
4178,8356,-4178,1,0.6915103808456957,1
4179,8358,-4179,1,0.6685119613034473,1
4180,8360,-4180,1,0.7358073033314109,1
4181,8362,-4181,1,0.44232210810157424,1
4183,8366,-4183,1,0.5280518503707762,1
4184,8368,-4184,1,0.4053344370071955,1
4186,8372,-4186,1,0.9800260941959061,1
4187,8374,-4187,1,0.6133447495462805,1
4188,8376,-4188,1,0.48442586863294745,1
4189,8378,-4189,1,0.9192731716511403,1
4191,8382,-4191,1,0.041382856703303106,1
4192,8384,-4192,1,0.4660334174364851,1
4194,8388,-4194,1,0.16543839231840263,1
4198,8396,-4198,1,0.37270292719483755,1
4199,8398,-4199,1,0.049183834357746314,1
4200,8400,-4200,1,0.5555343466434657,1
4202,8404,-4202,1,0.1051900015360141,1
4203,8406,-4203,1,0.6642552277674624,1
4204,8408,-4204,1,0.22003595765540518,1
4205,8410,-4205,1,0.4501725082543231,1
4207,8414,-4207,1,0.9648679929582227,1
4209,8418,-4209,1,0.3474417317797879,1
4210,8420,-4210,1,0.47731754924910386,1
4211,8422,-4211,1,0.17191994964441615,1
4212,8424,-4212,1,0.7946586098809144,1
4213,8426,-4213,1,0.5393015554172564,1
4214,8428,-4214,1,0.17441020775036553,1
4215,8430,-4215,1,0.39481686577812847,1
4219,8438,-4219,1,0.9194077938125714,1
4221,8442,-4221,1,0.9537410326995069,1
4222,8444,-4222,1,0.5361353458790573,1
4224,8448,-4224,1,0.34183911943365075,1
4225,8450,-4225,1,0.5215285850514769,1
4226,8452,-4226,1,0.011556527129650496,1
4228,8456,-4228,1,0.7554647949150624,1
4229,8458,-4229,1,0.7244989683563118,1
4232,8464,-4232,1,0.5264411287792471,1
4233,8466,-4233,1,0.37406233071374706,1
4236,8472,-4236,1,0.25959181980775614,1
4239,8478,-4239,1,0.9867565294192948,1
4240,8480,-4240,1,0.6820808207320926,1
4241,8482,-4241,1,0.9287921872516673,1
4242,8484,-4242,1,0.09382477229456743,1
4244,8488,-4244,1,0.46789373143976454,1
4245,8490,-4245,1,0.26581336346991413,1
4247,8494,-4247,1,0.8730184388889727,1
4248,8496,-4248,1,0.07254890424543958,1
4249,8498,-4249,1,0.24789343327762225,1
4250,8500,-4250,1,0.780118149879266,1
4251,8502,-4251,1,0.26008804228341154,1
4252,8504,-4252,1,0.6615749394324545,1
4253,8506,-4253,1,0.07309653939919736,1
4255,8510,-4255,1,0.3675546035419427,1
4256,8512,-4256,1,0.0335390343509151,1
4257,8514,-4257,1,0.19994203809448297,1
4258,8516,-4258,1,0.6493514461764771,1
4259,8518,-4259,1,0.08956739902095823,1
4262,8524,-4262,1,0.5125140863366804,1
4265,8530,-4265,1,0.452104890231126,1
4266,8532,-4266,1,0.4930705331741021,1
4268,8536,-4268,1,0.7383844255221508,1
4269,8538,-4269,1,0.7437618443745213,1
4270,8540,-4270,1,0.10224698516575792,1
4273,8546,-4273,1,0.894587025068662,1
4274,8548,-4274,1,0.6850503912293439,1
4275,8550,-4275,1,0.008596929664057118,1
4276,8552,-4276,1,0.5243286833104668,1
4277,8554,-4277,1,0.8898037827542317,1
4278,8556,-4278,1,0.3930387247145487,1
4284,8568,-4284,1,0.6856614845166119,1
4287,8574,-4287,1,0.038615558717934206,1
4288,8576,-4288,1,0.7204145224232837,1
4289,8578,-4289,1,0.30325400635232314,1
4294,8588,-4294,1,0.199381258668066,1
4296,8592,-4296,1,0.7908862206389874,1
4297,8594,-4297,1,0.7857450509547175,1
4298,8596,-4298,1,0.232434642664458,1
4299,8598,-4299,1,0.0658585213244095,1
4300,8600,-4300,1,0.5029547218105782,1
4304,8608,-4304,1,0.8166042836805848,1
4305,8610,-4305,1,0.11038729523416446,1
4306,8612,-4306,1,0.08812960012891502,1
4308,8616,-4308,1,0.12672254023006613,1
4309,8618,-4309,1,0.40777443215755604,1
4310,8620,-4310,1,0.06195927229842513,1
4311,8622,-4311,1,0.9885108143557298,1
4313,8626,-4313,1,0.8106003720507471,1
4315,8630,-4315,1,0.7805943472448643,1
4317,8634,-4317,1,0.3541547263085174,1
4319,8638,-4319,1,0.177475617456767,1
4321,8642,-4321,1,0.9458367019769308,1
4323,8646,-4323,1,0.8119135905913529,1
4324,8648,-4324,1,0.7270299070929193,1
4326,8652,-4326,1,0.5026445902667911,1
4327,8654,-4327,1,0.18800120752116178,1
4328,8656,-4328,1,0.07147426240922194,1
4329,8658,-4329,1,0.474157251236348,1
4330,8660,-4330,1,0.9123711767397614,1
4332,8664,-4332,1,0.014868492003779932,1
4333,8666,-4333,1,0.43661072549047086,1
4335,8670,-4335,1,0.1185401011399756,1
4337,8674,-4337,1,0.5162014732292188,1
4338,8676,-4338,1,0.3611762980771248,1
4339,8678,-4339,1,0.569582716570783,1
4342,8684,-4342,1,0.42144316129213455,1
4343,8686,-4343,1,0.5899291531897972,1
4346,8692,-4346,1,0.4456552429341595,1
4349,8698,-4349,1,0.3952600877720758,1
4350,8700,-4350,1,0.3719506093756926,1
4351,8702,-4351,1,0.9643440065049238,1
4352,8704,-4352,1,0.9634627138845431,1
4353,8706,-4353,1,0.5027872104657275,1
4354,8708,-4354,1,0.5265713995610011,1
4355,8710,-4355,1,0.1682034265458222,1
4356,8712,-4356,1,0.8971587308453846,1
4358,8716,-4358,1,0.5479387465052512,1
4359,8718,-4359,1,0.4308180127799086,1
4360,8720,-4360,1,0.3897969369143499,1
4363,8726,-4363,1,0.36857286149424673,1
4365,8730,-4365,1,0.4338606201244144,1
4368,8736,-4368,1,0.5100475286292456,1
4369,8738,-4369,1,0.6421269409576139,1
4370,8740,-4370,1,0.289259906850422,1
4371,8742,-4371,1,0.6080525781957742,1
4372,8744,-4372,1,0.5288530581792216,1
4373,8746,-4373,1,0.4643447794471791,1
4374,8748,-4374,1,0.22971942045206384,1
4375,8750,-4375,1,0.2879592613068047,1
4376,8752,-4376,1,0.8094897145661022,1
4377,8754,-4377,1,0.6091192784711041,1
4378,8756,-4378,1,0.9461003954368943,1
4383,8766,-4383,1,0.05628714200459484,1
4384,8768,-4384,1,0.12486640708687058,1
4388,8776,-4388,1,0.06576084927339299,1
4389,8778,-4389,1,0.5119294798023019,1
4390,8780,-4390,1,0.19821882096678278,1
4391,8782,-4391,1,0.8860317748717988,1
4392,8784,-4392,1,0.9137430169303553,1
4396,8792,-4396,1,0.31600595692908817,1
4397,8794,-4397,1,0.5220028341775275,1
4398,8796,-4398,1,0.6195077193942166,1
4400,8800,-4400,1,0.5797371571440081,1
4401,8802,-4401,1,0.08058254544832266,1
4405,8810,-4405,1,0.69662240914238,1
4406,8812,-4406,1,0.9817164076225054,1
4407,8814,-4407,1,0.02897248943239994,1
4408,8816,-4408,1,0.4795848582862543,1
4409,8818,-4409,1,0.9832136913038244,1
4410,8820,-4410,1,0.9243528421243773,1
4411,8822,-4411,1,0.8412939683436983,1
4412,8824,-4412,1,0.9597233391685234,1
4413,8826,-4413,1,0.8906470834386072,1
4415,8830,-4415,1,0.379114335172819,1
4416,8832,-4416,1,0.6057710035490553,1
4419,8838,-4419,1,0.5367238671870217,1
4421,8842,-4421,1,0.19465169835525487,1
4422,8844,-4422,1,0.18470096035175043,1
4425,8850,-4425,1,0.41206167147837414,1
4426,8852,-4426,1,0.17274552283327615,1
4428,8856,-4428,1,0.36517968047206106,1
4429,8858,-4429,1,0.7724948180858808,1
4431,8862,-4431,1,0.3564535835197147,1
4433,8866,-4433,1,0.5426197241880565,1
4434,8868,-4434,1,0.6467027323700689,1
4435,8870,-4435,1,0.958864506824039,1
4436,8872,-4436,1,0.5920961843950004,1
4437,8874,-4437,1,0.5081317702942814,1
4438,8876,-4438,1,0.4808378298492427,1
4440,8880,-4440,1,0.6816261612328088,1
4441,8882,-4441,1,0.6363017655215396,1
4442,8884,-4442,1,0.7430461992578342,1
4443,8886,-4443,1,0.9771058010411412,1
4445,8890,-4445,1,0.860896019260718,1
4446,8892,-4446,1,0.9505703910649185,1
4447,8894,-4447,1,0.31285182679513746,1
4449,8898,-4449,1,0.2403455073470132,1
4450,8900,-4450,1,0.6843896393499362,1
4452,8904,-4452,1,0.8255502195299361,1
4453,8906,-4453,1,0.5614884759772899,1
4454,8908,-4454,1,0.2561945005461118,1
4455,8910,-4455,1,0.18684893130964042,1
4456,8912,-4456,1,0.012242141605772527,1
4457,8914,-4457,1,0.15425670634182143,1
4461,8922,-4461,1,0.5334909984086056,1
4462,8924,-4462,1,0.604396535879079,1
4464,8928,-4464,1,0.5449185639678513,1
4466,8932,-4466,1,0.8918729780813726,1
4467,8934,-4467,1,0.15792204684932343,1
4468,8936,-4468,1,0.6279356832703544,1
4469,8938,-4469,1,0.2310152282559207,1
4470,8940,-4470,1,0.289276706932902,1
4471,8942,-4471,1,0.536622127640224,1
4473,8946,-4473,1,0.7250198557883559,1
4474,8948,-4474,1,0.9273196160716611,1
4478,8956,-4478,1,0.9834309590177689,1
4479,8958,-4479,1,0.7285642710446874,1
4482,8964,-4482,1,0.20267414746902823,1
4484,8968,-4484,1,0.8874234104137232,1
4485,8970,-4485,1,0.9563009615448962,1
4486,8972,-4486,1,0.9449209459225062,1
4487,8974,-4487,1,0.018840848501437968,1
4490,8980,-4490,1,0.6971880632727703,1
4491,8982,-4491,1,0.6457442025334625,1
4493,8986,-4493,1,0.2971838305551324,1
4494,8988,-4494,1,0.0777221919951313,1
4495,8990,-4495,1,0.2615197142448673,1
4496,8992,-4496,1,0.2015312727128198,1
4497,8994,-4497,1,0.8224457268382939,1
4498,8996,-4498,1,0.7081840400169145,1
4500,9000,-4500,1,0.22772235891026082,1
4501,9002,-4501,1,0.33611785349202783,1
4505,9010,-4505,1,0.09354908039896204,1
4507,9014,-4507,1,0.8991097707059752,1
4511,9022,-4511,1,0.9020832185057837,1
4512,9024,-4512,1,0.48760043644903595,1
4513,9026,-4513,1,0.08024564032028247,1
4514,9028,-4514,1,0.1379404438408791,1
4518,9036,-4518,1,0.11795042698005753,1
4520,9040,-4520,1,0.44028622103605863,1
4521,9042,-4521,1,0.9393861590233151,1
4524,9048,-4524,1,0.4824854334697246,1
4527,9054,-4527,1,0.4393341022492674,1
4530,9060,-4530,1,0.6481108230411241,1
4531,9062,-4531,1,0.40841144563357845,1
4532,9064,-4532,1,0.5177358266929954,1
4533,9066,-4533,1,0.9547404451114169,1
4534,9068,-4534,1,0.08297896117326986,1
4535,9070,-4535,1,0.19399602911191205,1
4536,9072,-4536,1,0.6832002667559897,1
4538,9076,-4538,1,0.09412311715810195,1
4539,9078,-4539,1,0.6358411381249826,1
4540,9080,-4540,1,0.6859267495004625,1
4541,9082,-4541,1,0.20842562209844184,1
4542,9084,-4542,1,0.879363442040268,1
4543,9086,-4543,1,0.14560415966521978,1
4544,9088,-4544,1,0.9233240184185286,1
4545,9090,-4545,1,0.8857517949658269,1
4546,9092,-4546,1,0.3631567712711852,1
4547,9094,-4547,1,0.2522152343723286,1
4548,9096,-4548,1,0.995284082319438,1
4552,9104,-4552,1,0.6402633781957324,1
4553,9106,-4553,1,0.9517095346605313,1
4554,9108,-4554,1,0.7030579887361063,1
4555,9110,-4555,1,0.14085827068029289,1
4556,9112,-4556,1,0.49901049274708775,1
4557,9114,-4557,1,0.8563026127629277,1
4558,9116,-4558,1,0.2537758795241647,1
4560,9120,-4560,1,0.35070602061977296,1
4561,9122,-4561,1,0.6897258763164645,1
4563,9126,-4563,1,0.9882398548032925,1
4564,9128,-4564,1,0.1807656309376645,1
4566,9132,-4566,1,0.24370379408114262,1
4567,9134,-4567,1,0.24268988108084377,1
4568,9136,-4568,1,0.7146800241396515,1
4569,9138,-4569,1,0.7283068494791324,1
4570,9140,-4570,1,0.21394795844147474,1
4572,9144,-4572,1,0.9828161690602035,1
4576,9152,-4576,1,0.2092297506634333,1
4577,9154,-4577,1,0.5716949363010942,1
4578,9156,-4578,1,0.1297205030374523,1
4579,9158,-4579,1,0.32805954531305226,1
4581,9162,-4581,1,0.7709694156934886,1
4582,9164,-4582,1,0.9618520680298731,1
4583,9166,-4583,1,0.4295639525529632,1
4584,9168,-4584,1,0.997786133993928,1
4585,9170,-4585,1,0.6809974134897137,1
4586,9172,-4586,1,0.6471323996375155,1
4587,9174,-4587,1,0.820645751341746,1
4588,9176,-4588,1,0.241542999299713,1
4589,9178,-4589,1,0.7063559160616374,1
4590,9180,-4590,1,0.5527933141700584,1
4591,9182,-4591,1,0.9852922468843082,1
4592,9184,-4592,1,0.08507846242469286,1
4595,9190,-4595,1,0.14972072500982847,1
4596,9192,-4596,1,0.7046927096285543,1
4598,9196,-4598,1,0.8172089637517752,1
4599,9198,-4599,1,0.9042374953451142,1
4601,9202,-4601,1,0.4228736885365063,1
4602,9204,-4602,1,0.09847420521197014,1
4606,9212,-4606,1,0.7588215868702114,1
4607,9214,-4607,1,0.6312901273095899,1
4612,9224,-4612,1,0.3296129566795717,1
4613,9226,-4613,1,0.2719108402245348,1
4614,9228,-4614,1,0.8897293413424296,1
4617,9234,-4617,1,0.7811758225553661,1
4619,9238,-4619,1,0.9519868549693131,1
4622,9244,-4622,1,0.5209052968623371,1
4623,9246,-4623,1,0.5440200652192577,1
4624,9248,-4624,1,0.2904085384294506,1
4625,9250,-4625,1,0.36712226811024784,1
4626,9252,-4626,1,0.3052254146747847,1
4627,9254,-4627,1,0.13760729142066863,1
4628,9256,-4628,1,0.6125564174600479,1
4629,9258,-4629,1,0.284811826080015,1
4631,9262,-4631,1,0.5568699778753884,1
4632,9264,-4632,1,0.7547852154329016,1
4633,9266,-4633,1,0.6915436100337176,1
4634,9268,-4634,1,0.9390127043412376,1
4635,9270,-4635,1,0.7693446115577871,1
4636,9272,-4636,1,0.9762838264665913,1
4637,9274,-4637,1,0.42845140003584437,1
4638,9276,-4638,1,0.17571117731981734,1
4640,9280,-4640,1,0.09283631170285855,1
4641,9282,-4641,1,0.7965570090833404,1
4643,9286,-4643,1,0.8618159651764454,1
4644,9288,-4644,1,0.9492751616996962,1
4645,9290,-4645,1,0.1270716167896555,1
4646,9292,-4646,1,0.8321528058729688,1
4648,9296,-4648,1,0.5960033646227143,1
4650,9300,-4650,1,0.4975114189507165,1
4651,9302,-4651,1,0.6002594869551067,1
4652,9304,-4652,1,0.07111871045426921,1
4653,9306,-4653,1,0.1485519520430164,1
4654,9308,-4654,1,0.6839264847840354,1
4655,9310,-4655,1,0.516240714106331,1
4656,9312,-4656,1,0.09310968352156046,1
4658,9316,-4658,1,0.7399910818359864,1
4659,9318,-4659,1,0.17173866039586738,1
4660,9320,-4660,1,0.616263618985408,1
4661,9322,-4661,1,0.8594641673371348,1
4665,9330,-4665,1,0.8218316244347373,1
4666,9332,-4666,1,0.1310647649515917,1
4667,9334,-4667,1,0.28372041833260153,1
4668,9336,-4668,1,0.7681048285262227,1
4669,9338,-4669,1,0.346145113000519,1
4671,9342,-4671,1,0.4665415373028938,1
4672,9344,-4672,1,0.7936490820527383,1
4673,9346,-4673,1,0.6657874874668607,1
4674,9348,-4674,1,0.6445801798699934,1
4676,9352,-4676,1,0.33148766701991617,1
4677,9354,-4677,1,0.4261673866089747,1
4680,9360,-4680,1,0.6907868238588122,1
4681,9362,-4681,1,0.6669108319576115,1
4682,9364,-4682,1,0.2226003620475817,1
4683,9366,-4683,1,0.3810701551995175,1
4685,9370,-4685,1,0.06137043275196541,1
4686,9372,-4686,1,0.32307008809885984,1
4687,9374,-4687,1,0.8570318572814576,1
4688,9376,-4688,1,0.5704239355303945,1
4690,9380,-4690,1,0.050561517185965243,1
4691,9382,-4691,1,0.899231999718707,1
4692,9384,-4692,1,0.7948173541319679,1
4693,9386,-4693,1,0.4197475511575661,1
4694,9388,-4694,1,0.016918279412860726,1
4695,9390,-4695,1,0.8710975886076424,1
4697,9394,-4697,1,0.2509925310339364,1
4698,9396,-4698,1,0.9395891066058103,1
4699,9398,-4699,1,0.4405555180600388,1
4700,9400,-4700,1,0.5911082012848667,1
4701,9402,-4701,1,0.7812023896046519,1
4702,9404,-4702,1,0.039149551768338564,1
4703,9406,-4703,1,0.9496577293846477,1
4704,9408,-4704,1,0.4547539538544041,1
4705,9410,-4705,1,0.5808829568328835,1
4707,9414,-4707,1,0.5315428888139268,1
4709,9418,-4709,1,0.27750021293434146,1
4712,9424,-4712,1,0.9682515090635206,1
4713,9426,-4713,1,0.14746439893261298,1
4716,9432,-4716,1,0.3712297990370188,1
4718,9436,-4718,1,0.982814001285761,1
4720,9440,-4720,1,0.1705802650767475,1
4721,9442,-4721,1,0.007737987285791226,1
4722,9444,-4722,1,0.8737671789714263,1
4725,9450,-4725,1,0.6113951646570859,1
4726,9452,-4726,1,0.014951580659918973,1
4727,9454,-4727,1,0.2510082819318664,1
4728,9456,-4728,1,0.24763395740630523,1
4729,9458,-4729,1,0.3317661513815541,1
4731,9462,-4731,1,0.36353867520735694,1
4732,9464,-4732,1,0.25444259705105543,1
4733,9466,-4733,1,0.39593136443326626,1
4738,9476,-4738,1,0.4606398138382465,1
4739,9478,-4739,1,0.017389191570495566,1
4740,9480,-4740,1,0.115686814891935,1
4741,9482,-4741,1,0.9637293386464759,1
4743,9486,-4743,1,0.8069846282807984,1
4746,9492,-4746,1,0.46479531143487285,1
4747,9494,-4747,1,0.40838442728554203,1
4749,9498,-4749,1,0.8741179362641873,1
4750,9500,-4750,1,0.5722049012508388,1
4751,9502,-4751,1,0.7272282968466396,1
4752,9504,-4752,1,0.9030917416009806,1
4753,9506,-4753,1,0.20495091591483927,1
4754,9508,-4754,1,0.4409604038873658,1
4755,9510,-4755,1,0.4133871224883562,1
4756,9512,-4756,1,0.9467574286100403,1
4758,9516,-4758,1,0.12512178255537143,1
4759,9518,-4759,1,0.6741596286754155,1
4760,9520,-4760,1,0.911726377670227,1
4761,9522,-4761,1,0.12154935919602838,1
4762,9524,-4762,1,0.05039172989379115,1
4763,9526,-4763,1,0.19513698132760693,1
4766,9532,-4766,1,0.8073005755645,1
4768,9536,-4768,1,0.17288789959926876,1
4769,9538,-4769,1,0.5210363111470314,1
4771,9542,-4771,1,0.09297693238846194,1
4772,9544,-4772,1,0.6299491581513835,1
4776,9552,-4776,1,0.9262440495076767,1
4777,9554,-4777,1,0.2635509657624002,1
4778,9556,-4778,1,0.9498257387304788,1
4780,9560,-4780,1,0.03279200313338426,1
4781,9562,-4781,1,0.11370575590810716,1
4782,9564,-4782,1,0.6364178331204249,1
4783,9566,-4783,1,0.32762507684935716,1
4784,9568,-4784,1,0.30278498968676393,1
4785,9570,-4785,1,0.40487663856425293,1
4789,9578,-4789,1,0.7448341647089138,1
4790,9580,-4790,1,0.4503119169294114,1
4791,9582,-4791,1,0.9113526822089326,1
4792,9584,-4792,1,0.2237662976747684,1
4794,9588,-4794,1,0.8023459810548174,1
4796,9592,-4796,1,0.20150908397865708,1
4797,9594,-4797,1,0.17858321006774158,1
4798,9596,-4798,1,0.8775842484643411,1
4799,9598,-4799,1,0.1437914906928216,1
4803,9606,-4803,1,0.18649111936338192,1
4804,9608,-4804,1,0.4148629495590722,1
4806,9612,-4806,1,0.9253787265745502,1
4807,9614,-4807,1,0.5331017323389593,1
4808,9616,-4808,1,0.7003488890806273,1
4811,9622,-4811,1,0.47983264410158344,1
4813,9626,-4813,1,0.7668170708238413,1
4814,9628,-4814,1,0.36829291547169607,1
4815,9630,-4815,1,0.19525489414808528,1
4816,9632,-4816,1,0.7372917989597088,1
4817,9634,-4817,1,0.6335340193218604,1
4818,9636,-4818,1,0.08752012049536206,1
4819,9638,-4819,1,0.28533024619973724,1
4822,9644,-4822,1,0.5042146638288347,1
4827,9654,-4827,1,0.9016919447078778,1
4828,9656,-4828,1,0.7323133124339063,1
4829,9658,-4829,1,0.09536288476930799,1
4830,9660,-4830,1,0.01627059549292864,1
4831,9662,-4831,1,0.09039700682982021,1
4832,9664,-4832,1,0.8425459594483213,1
4833,9666,-4833,1,0.4298030734031203,1
4834,9668,-4834,1,0.9546244459831579,1
4835,9670,-4835,1,0.194363750314684,1
4836,9672,-4836,1,0.49277751930799385,1
4837,9674,-4837,1,0.10543494307053747,1
4838,9676,-4838,1,0.7934809914511127,1
4839,9678,-4839,1,0.3488965084466613,1
4841,9682,-4841,1,0.6399330436901938,1
4842,9684,-4842,1,0.011449603795220975,1
4843,9686,-4843,1,0.7204397412243528,1
4844,9688,-4844,1,0.01577803040467407,1
4845,9690,-4845,1,0.72664146387274,1
4849,9698,-4849,1,0.3280405610945826,1
4850,9700,-4850,1,0.36184483714226734,1
4851,9702,-4851,1,0.8267221054537799,1
4853,9706,-4853,1,0.6911568717535623,1
4854,9708,-4854,1,0.9852161071977741,1
4855,9710,-4855,1,0.51584656360348,1
4858,9716,-4858,1,0.6154722948874717,1
4859,9718,-4859,1,0.2640038074535974,1
4860,9720,-4860,1,0.16250903287967178,1
4861,9722,-4861,1,0.6912136705903891,1
4863,9726,-4863,1,0.6403708546508603,1
4864,9728,-4864,1,0.708668164373735,1
4865,9730,-4865,1,0.5007237236843243,1
4866,9732,-4866,1,0.20737225301947404,1
4867,9734,-4867,1,0.5012212666881634,1
4868,9736,-4868,1,0.08002483212165667,1
4869,9738,-4869,1,0.583279960228549,1
4870,9740,-4870,1,0.29434332637250593,1
4873,9746,-4873,1,0.07490903781049363,1
4874,9748,-4874,1,0.8990457318956949,1
4875,9750,-4875,1,0.31718687673452073,1
4876,9752,-4876,1,0.45451852499714995,1
4877,9754,-4877,1,0.8756184568523186,1
4878,9756,-4878,1,0.719807929632606,1
4879,9758,-4879,1,0.7683175369799355,1
4880,9760,-4880,1,0.19374948506455358,1
4881,9762,-4881,1,0.7790823084289996,1
4882,9764,-4882,1,0.8434353398412601,1
4883,9766,-4883,1,0.7566393656909517,1
4884,9768,-4884,1,0.9739840185764155,1
4885,9770,-4885,1,0.6833628971742021,1
4886,9772,-4886,1,0.3016340341738126,1
4887,9774,-4887,1,0.10166204890063657,1
4888,9776,-4888,1,0.42076816437680864,1
4889,9778,-4889,1,0.8506382946286722,1
4891,9782,-4891,1,0.0300343697753096,1
4892,9784,-4892,1,0.09917664887619027,1
4893,9786,-4893,1,0.14032764499436612,1
4894,9788,-4894,1,0.9903188539267296,1
4895,9790,-4895,1,0.19158175178219505,1
4896,9792,-4896,1,0.8598701276893638,1
4898,9796,-4898,1,0.4443721574635564,1
4899,9798,-4899,1,0.8004497534524481,1
4900,9800,-4900,1,0.11287557520417912,1
4901,9802,-4901,1,0.4703690104730023,1
4903,9806,-4903,1,0.6161438842235273,1
4904,9808,-4904,1,0.8174934605461583,1
4905,9810,-4905,1,0.968445146439103,1
4906,9812,-4906,1,0.5418188764638665,1
4907,9814,-4907,1,0.2076983816530209,1
4908,9816,-4908,1,0.6232392307401442,1
4909,9818,-4909,1,0.5440485796636688,1
4910,9820,-4910,1,0.962501676602912,1
4912,9824,-4912,1,0.14420590810881917,1
4913,9826,-4913,1,0.04339536986391668,1
4914,9828,-4914,1,0.02057676278165077,1
4915,9830,-4915,1,0.45724498025779237,1
4916,9832,-4916,1,0.5082005115869456,1
4917,9834,-4917,1,0.9713983404086556,1
4919,9838,-4919,1,0.385421419875974,1
4920,9840,-4920,1,0.4114286355154948,1
4924,9848,-4924,1,0.2608494941017615,1
4925,9850,-4925,1,0.20122860326379421,1
4927,9854,-4927,1,0.2829412244818168,1
4929,9858,-4929,1,0.13949280913877127,1
4930,9860,-4930,1,0.6901473089832655,1
4931,9862,-4931,1,0.8259855214918674,1
4932,9864,-4932,1,0.6895602415350356,1
4933,9866,-4933,1,0.5151193341536077,1
4934,9868,-4934,1,0.15735788978618792,1
4936,9872,-4936,1,0.29085745562039445,1
4940,9880,-4940,1,0.39650358263605334,1
4941,9882,-4941,1,0.4718385921705104,1
4943,9886,-4943,1,0.12792984993250534,1
4948,9896,-4948,1,0.5417702162103087,1
4950,9900,-4950,1,0.40191170137370236,1
4954,9908,-4954,1,0.2900083014556999,1
4955,9910,-4955,1,0.5484591243870668,1
4960,9920,-4960,1,0.9011505968226848,1
4961,9922,-4961,1,0.294459199847819,1
4962,9924,-4962,1,0.6758864296953667,1
4964,9928,-4964,1,0.5726766142973224,1
4965,9930,-4965,1,0.15272681560692236,1
4966,9932,-4966,1,0.0053163093641303005,1
4967,9934,-4967,1,0.807350493631824,1
4968,9936,-4968,1,0.22189677378915296,1
4969,9938,-4969,1,0.338859095512855,1
4970,9940,-4970,1,0.8739827048312798,1
4971,9942,-4971,1,0.7142563012904439,1
4972,9944,-4972,1,0.9670439022164758,1
4973,9946,-4973,1,0.7655517469529891,1
4974,9948,-4974,1,0.08550946528416059,1
4976,9952,-4976,1,0.6070832398749362,1
4980,9960,-4980,1,0.5483004069224974,1
4981,9962,-4981,1,0.5910455960159074,1
4982,9964,-4982,1,0.03955308590424067,1
4983,9966,-4983,1,0.3781576304328942,1
4985,9970,-4985,1,0.6177081989604742,1
4986,9972,-4986,1,0.9174433890946581,1
4987,9974,-4987,1,0.004795140587762647,1
4989,9978,-4989,1,0.9581984839171112,1
4990,9980,-4990,1,0.2191021211578471,1
4991,9982,-4991,1,0.7990061201513188,1
4993,9986,-4993,1,0.883172997170204,1
4994,9988,-4994,1,0.6618062920344061,1
4995,9990,-4995,1,0.06579390337576807,1
4997,9994,-4997,1,0.34394967843316315,1
4998,9996,-4998,1,0.5452323578228906,1
4999,9998,-4999,1,0.12248234832736005,1
5000,10000,-5000,1,0.6161443672028251,1
5001,10002,-5001,1,0.6591575441394243,1
5002,10004,-5002,1,0.454578409180336,1
5003,10006,-5003,1,0.426502628195917,1
5005,10010,-5005,1,0.5910535494623205,1
5008,10016,-5008,1,0.09480355868569434,1
5009,10018,-5009,1,0.7378960410881646,1
5011,10022,-5011,1,0.6420445574939252,1
5012,10024,-5012,1,0.06189774761456335,1
5013,10026,-5013,1,0.9638823144973376,1
5015,10030,-5015,1,0.27137500658829483,1
5016,10032,-5016,1,0.16860748221307797,1
5018,10036,-5018,1,0.3238275215416151,1
5019,10038,-5019,1,0.8972532910580461,1
5020,10040,-5020,1,0.9288867071395991,1
5021,10042,-5021,1,0.802314917429425,1
5022,10044,-5022,1,0.3499420242066772,1
5023,10046,-5023,1,0.8444799450759938,1
5024,10048,-5024,1,0.8720256001430917,1
5027,10054,-5027,1,0.7402229875132954,1
5029,10058,-5029,1,0.9241121465938195,1
5032,10064,-5032,1,0.7045225126929483,1
5033,10066,-5033,1,0.761795169937338,1
5034,10068,-5034,1,0.26531837974552197,1
5035,10070,-5035,1,0.8188061049631344,1
5038,10076,-5038,1,0.6001409515371685,1
5039,10078,-5039,1,0.29221791641115014,1
5040,10080,-5040,1,0.44625256705810534,1
5042,10084,-5042,1,0.08139567333241504,1
5043,10086,-5043,1,0.7849418008835553,1
5045,10090,-5045,1,0.14481751627567097,1
5046,10092,-5046,1,0.32353408430969777,1
5048,10096,-5048,1,0.5430061741853068,1
5049,10098,-5049,1,0.060491300244228996,1
5050,10100,-5050,1,0.8050352362331725,1
5052,10104,-5052,1,0.6246336801956893,1
5053,10106,-5053,1,0.3640770042402758,1
5054,10108,-5054,1,0.843615370223578,1
5056,10112,-5056,1,0.04202165675356928,1
5057,10114,-5057,1,0.28117053201701725,1
5058,10116,-5058,1,0.40374076802196546,1
5059,10118,-5059,1,0.41464248781056556,1
5060,10120,-5060,1,0.5629367404946722,1
5062,10124,-5062,1,0.5186270366892328,1
5064,10128,-5064,1,0.906475133854126,1
5065,10130,-5065,1,0.929608207026961,1
5066,10132,-5066,1,0.05773107177886272,1
5067,10134,-5067,1,0.5350866519290981,1
5068,10136,-5068,1,0.6371855641696084,1
5071,10142,-5071,1,0.10524021915244974,1
5072,10144,-5072,1,0.8050565479074842,1
5074,10148,-5074,1,0.6667955069527601,1
5077,10154,-5077,1,0.9174924428139997,1
5078,10156,-5078,1,0.7181550584140856,1
5079,10158,-5079,1,0.03231233705454761,1
5082,10164,-5082,1,0.38778810297625255,1
5083,10166,-5083,1,0.634701071818874,1
5084,10168,-5084,1,0.7767546222890542,1
5087,10174,-5087,1,0.9029605583036255,1
5088,10176,-5088,1,0.10456897936041465,1
5090,10180,-5090,1,0.08095989638486101,1
5092,10184,-5092,1,0.5504240426389383,1
5093,10186,-5093,1,0.08625876843428615,1
5096,10192,-5096,1,0.6900280503078152,1
5097,10194,-5097,1,0.4677418899181647,1
5098,10196,-5098,1,0.8693952292008279,1
5099,10198,-5099,1,0.053782841140250004,1
5101,10202,-5101,1,0.29460380236193906,1
5102,10204,-5102,1,0.4853164577011023,1
5104,10208,-5104,1,0.19970735213823454,1
5105,10210,-5105,1,0.5985884840363181,1
5106,10212,-5106,1,0.11832922524702594,1
5107,10214,-5107,1,0.01975013520306257,1
5109,10218,-5109,1,0.6277146465198065,1
5112,10224,-5112,1,0.10971554251566085,1
5113,10226,-5113,1,0.5051983294310353,1
5115,10230,-5115,1,0.018526545760111812,1
5117,10234,-5117,1,0.7310219155950243,1
5118,10236,-5118,1,0.3993031846123606,1
5119,10238,-5119,1,0.5975177119139352,1
5121,10242,-5121,1,0.05899875469939442,1
5122,10244,-5122,1,0.5817781793599207,1
5124,10248,-5124,1,0.9968309237324358,1
5125,10250,-5125,1,0.45735610392836823,1
5128,10256,-5128,1,0.0022071712688664924,1
5130,10260,-5130,1,0.5396784965446024,1
5132,10264,-5132,1,0.8097522184198159,1
5133,10266,-5133,1,0.08100326413878634,1
5134,10268,-5134,1,0.8002992912755825,1
5136,10272,-5136,1,0.019894523114324714,1
5137,10274,-5137,1,0.5395859988275112,1
5138,10276,-5138,1,0.3351977501860579,1
5139,10278,-5139,1,0.7346152757701363,1
5140,10280,-5140,1,0.5465333695411968,1
5141,10282,-5141,1,0.20623298041954008,1
5142,10284,-5142,1,0.30982664268797633,1
5143,10286,-5143,1,0.8025591699735066,1
5144,10288,-5144,1,0.8810038506361645,1
5145,10290,-5145,1,0.5990706957411378,1
5146,10292,-5146,1,0.960907627062952,1
5148,10296,-5148,1,0.8663759952564009,1
5150,10300,-5150,1,0.5985148923960993,1
5151,10302,-5151,1,0.28562647489142035,1
5152,10304,-5152,1,0.7853722325538997,1
5153,10306,-5153,1,0.6604815299937589,1
5154,10308,-5154,1,0.9875984849657038,1
5155,10310,-5155,1,0.04220659205981747,1
5156,10312,-5156,1,0.39465971179679415,1
5157,10314,-5157,1,0.8679295472256037,1
5158,10316,-5158,1,0.9333830773775921,1
5162,10324,-5162,1,0.5973688577019071,1
5165,10330,-5165,1,0.5089312837803293,1
5166,10332,-5166,1,0.7314624213867639,1
5167,10334,-5167,1,0.7043551009504876,1
5168,10336,-5168,1,0.7081221837350977,1
5170,10340,-5170,1,0.572992406357123,1
5172,10344,-5172,1,0.5497010008056249,1
5175,10350,-5175,1,0.5028708491091357,1
5176,10352,-5176,1,0.6096835004304071,1
5177,10354,-5177,1,0.9356417400303011,1
5180,10360,-5180,1,0.8533445475800858,1
5181,10362,-5181,1,0.0380240195559165,1
5182,10364,-5182,1,0.9701787129289821,1
5183,10366,-5183,1,0.8411454080256207,1
5184,10368,-5184,1,0.8527060979279343,1
5185,10370,-5185,1,0.2880748575437907,1
5186,10372,-5186,1,0.20908080306994625,1
5187,10374,-5187,1,0.45134107842085947,1
5189,10378,-5189,1,0.4724856367537067,1
5191,10382,-5191,1,0.07298444402126114,1
5192,10384,-5192,1,0.14467674992145674,1
5193,10386,-5193,1,0.11123889039730828,1
5195,10390,-5195,1,0.8882656617389961,1
5196,10392,-5196,1,0.18720573615107228,1
5197,10394,-5197,1,0.4586211687265288,1
5199,10398,-5199,1,0.305486021126671,1
5201,10402,-5201,1,0.1762870223038865,1
5202,10404,-5202,1,0.015793637047581965,1
5203,10406,-5203,1,0.21759538762763164,1
5206,10412,-5206,1,0.2113808565239832,1
5211,10422,-5211,1,0.6403442174442087,1
5212,10424,-5212,1,0.2042929274874007,1
5213,10426,-5213,1,0.9304385425443416,1
5214,10428,-5214,1,0.002014676291396178,1
5215,10430,-5215,1,0.08540158425956479,1
5216,10432,-5216,1,0.8858294580207464,1
5217,10434,-5217,1,0.6195479196460777,1
5218,10436,-5218,1,0.8907191527296773,1
5219,10438,-5219,1,0.9738840758311018,1
5222,10444,-5222,1,0.5093713600063743,1
5223,10446,-5223,1,0.34071436655435294,1
5224,10448,-5224,1,0.434482682257332,1
5227,10454,-5227,1,0.08296646113487127,1
5228,10456,-5228,1,0.7264830678370324,1
5230,10460,-5230,1,0.26709794399072984,1
5232,10464,-5232,1,0.6892028056747737,1
5233,10466,-5233,1,0.7453700740229521,1
5234,10468,-5234,1,0.3585345376208572,1
5237,10474,-5237,1,0.8644143394739519,1
5239,10478,-5239,1,0.3085942211964451,1
5240,10480,-5240,1,0.723494729741503,1
5241,10482,-5241,1,0.3055647796237462,1
5242,10484,-5242,1,0.21165122602936104,1
5243,10486,-5243,1,0.16469652196073448,1
5244,10488,-5244,1,0.2410255186720328,1
5246,10492,-5246,1,0.32703744814287783,1
5247,10494,-5247,1,0.2087689717386928,1
5248,10496,-5248,1,0.4890102871648727,1
5249,10498,-5249,1,0.9939141347749705,1
5251,10502,-5251,1,0.7372982284288503,1
5253,10506,-5253,1,0.3567809068601463,1
5256,10512,-5256,1,0.7152794768678259,1
5257,10514,-5257,1,0.2940341499821161,1
5258,10516,-5258,1,0.5552244889743037,1
5259,10518,-5259,1,0.33067335220298455,1
5260,10520,-5260,1,0.6676934196717549,1
5261,10522,-5261,1,0.02620265693735413,1
5262,10524,-5262,1,0.4290144348175692,1
5263,10526,-5263,1,0.3498417194601976,1
5264,10528,-5264,1,0.2800718308592486,1
5265,10530,-5265,1,0.2895054678579524,1
5266,10532,-5266,1,0.40174723877288276,1
5268,10536,-5268,1,0.16438208602532123,1
5269,10538,-5269,1,0.1902639473034703,1
5271,10542,-5271,1,0.9278843585338646,1
5275,10550,-5275,1,0.837190529139917,1
5276,10552,-5276,1,0.9447446959026045,1
5277,10554,-5277,1,0.9597463719271303,1
5278,10556,-5278,1,0.9934364060887637,1
5280,10560,-5280,1,0.6652567531755692,1
5281,10562,-5281,1,0.23956351109628582,1
5282,10564,-5282,1,0.4494548339183374,1
5283,10566,-5283,1,0.275278502067169,1
5284,10568,-5284,1,0.19669309427284776,1
5285,10570,-5285,1,0.22125470825442117,1
5286,10572,-5286,1,0.6897409916926783,1
5288,10576,-5288,1,0.17885713499598777,1
5290,10580,-5290,1,0.28904786314698316,1
5291,10582,-5291,1,0.9987357351049395,1
5292,10584,-5292,1,0.9658889671019655,1
5293,10586,-5293,1,0.4324637497459397,1
5294,10588,-5294,1,0.4770744403121632,1
5296,10592,-5296,1,0.287558498641749,1
5300,10600,-5300,1,0.19957829808122451,1
5301,10602,-5301,1,0.2371499161770133,1
5302,10604,-5302,1,0.7203581279764643,1
5304,10608,-5304,1,0.3588847037673505,1
5306,10612,-5306,1,0.06846477644343418,1
5308,10616,-5308,1,0.4352146253190917,1
5310,10620,-5310,1,0.5134855717872121,1
5311,10622,-5311,1,0.3417817274450393,1
5312,10624,-5312,1,0.17573108241210222,1
5314,10628,-5314,1,0.7932112183661009,1
5316,10632,-5316,1,0.3976849843800272,1
5317,10634,-5317,1,0.13853773363586674,1
5319,10638,-5319,1,0.19931592558339806,1
5320,10640,-5320,1,0.40683896201259595,1
5321,10642,-5321,1,0.0913175976753412,1
5323,10646,-5323,1,0.040323660315037424,1
5324,10648,-5324,1,0.9996560842386121,1
5327,10654,-5327,1,0.7099846853973389,1
5328,10656,-5328,1,0.6822575000103052,1
5329,10658,-5329,1,0.6452597032186613,1
5330,10660,-5330,1,0.8337328629580762,1
5332,10664,-5332,1,0.11961556599871315,1
5333,10666,-5333,1,0.9100267563294494,1
5334,10668,-5334,1,0.06755199770909925,1
5337,10674,-5337,1,0.8544474245191782,1
5339,10678,-5339,1,0.43043051551613576,1
5341,10682,-5341,1,0.45498638750759934,1
5342,10684,-5342,1,0.7113586548805844,1
5343,10686,-5343,1,0.1137209287816392,1
5344,10688,-5344,1,0.8648228349039949,1
5345,10690,-5345,1,0.7104463560024088,1
5348,10696,-5348,1,0.8785777798066863,1
5349,10698,-5349,1,0.31703016272169804,1
5351,10702,-5351,1,0.0824552722773898,1
5352,10704,-5352,1,0.485053822950143,1
5354,10708,-5354,1,0.12398065560825822,1
5356,10712,-5356,1,0.32562045646485416,1
5359,10718,-5359,1,0.8795531048055937,1
5361,10722,-5361,1,0.14376128495134677,1
5362,10724,-5362,1,0.6510640824943225,1
5363,10726,-5363,1,0.5943642704815845,1
5364,10728,-5364,1,0.27637249525343155,1
5365,10730,-5365,1,0.7261119256027827,1
5366,10732,-5366,1,0.880798777738735,1
5369,10738,-5369,1,0.44480773179123767,1
5370,10740,-5370,1,0.0818521118136416,1
5371,10742,-5371,1,0.9788343096039156,1
5373,10746,-5373,1,0.9918906807450152,1
5374,10748,-5374,1,0.00998691133217644,1
5375,10750,-5375,1,0.80856870403613,1
5376,10752,-5376,1,0.21899639641078905,1
5377,10754,-5377,1,0.8357945264247196,1
5378,10756,-5378,1,0.697209386137544,1
5379,10758,-5379,1,0.2454969242505911,1
5380,10760,-5380,1,0.2962427614252314,1
5381,10762,-5381,1,0.1701373017407174,1
5383,10766,-5383,1,0.3605158435386855,1
5384,10768,-5384,1,0.9551512411766483,1
5387,10774,-5387,1,0.30705142395662,1
5388,10776,-5388,1,0.28461397712186687,1
5389,10778,-5389,1,0.23998751567583443,1
5390,10780,-5390,1,0.7967374901766807,1
5391,10782,-5391,1,0.046764621519024496,1
5393,10786,-5393,1,0.4588827804520371,1
5394,10788,-5394,1,0.0819913981789443,1
5396,10792,-5396,1,0.5805057651949123,1
5400,10800,-5400,1,0.6457902420625877,1
5401,10802,-5401,1,0.22793149649323352,1
5402,10804,-5402,1,0.911806486921166,1
5403,10806,-5403,1,0.9832066378142409,1
5406,10812,-5406,1,0.5586467152266162,1
5407,10814,-5407,1,0.22437104722324763,1
5408,10816,-5408,1,0.9814473408549871,1
5409,10818,-5409,1,0.7105037373368055,1
5413,10826,-5413,1,0.7802633065721899,1
5414,10828,-5414,1,0.46528757068853843,1
5415,10830,-5415,1,0.06579299958740803,1
5416,10832,-5416,1,0.0021043945783691953,1
5417,10834,-5417,1,0.41250542909571897,1
5419,10838,-5419,1,0.5276359216123424,1
5420,10840,-5420,1,0.9341223689482239,1
5421,10842,-5421,1,0.7254913411396412,1
5422,10844,-5422,1,0.8584641643759153,1
5424,10848,-5424,1,0.655670922984177,1
5425,10850,-5425,1,0.7642519315804369,1
5426,10852,-5426,1,0.7192576260474478,1
5427,10854,-5427,1,0.7449959945481387,1
5428,10856,-5428,1,0.2009457631073721,1
5430,10860,-5430,1,0.9136572395467695,1
5433,10866,-5433,1,0.5720778760303709,1
5434,10868,-5434,1,0.5778286848045252,1
5435,10870,-5435,1,0.05446143583078522,1
5437,10874,-5437,1,0.9950862692810989,1
5438,10876,-5438,1,0.6977252952593094,1
5439,10878,-5439,1,0.2502798831713543,1
5440,10880,-5440,1,0.4767969840289379,1
5441,10882,-5441,1,0.38436001317978385,1
5442,10884,-5442,1,0.9675691634505891,1
5443,10886,-5443,1,0.05473404601067755,1
5444,10888,-5444,1,0.8487067021598129,1
5445,10890,-5445,1,0.13635298134583196,1
5447,10894,-5447,1,0.09968796926201018,1
5448,10896,-5448,1,0.6641345942261404,1
5455,10910,-5455,1,0.26811467755654916,1
5456,10912,-5456,1,0.9691359251528956,1
5457,10914,-5457,1,0.8430809997789007,1
5458,10916,-5458,1,0.14190161559472625,1
5459,10918,-5459,1,0.2896319212235553,1
5460,10920,-5460,1,0.5350208395959184,1
5462,10924,-5462,1,0.9962590022510015,1
5465,10930,-5465,1,0.3522678572936956,1
5466,10932,-5466,1,0.5390445999569452,1
5467,10934,-5467,1,0.4024397601005987,1
5468,10936,-5468,1,0.9952739915763509,1
5469,10938,-5469,1,0.2802684332216626,1
5471,10942,-5471,1,0.6971099010702679,1
5472,10944,-5472,1,0.4640506477896088,1
5473,10946,-5473,1,0.028694714815329814,1
5474,10948,-5474,1,0.5926408876604047,1
5476,10952,-5476,1,0.10763040370898369,1
5479,10958,-5479,1,0.804810868845367,1
5480,10960,-5480,1,0.16630564474199738,1
5482,10964,-5482,1,0.05595957409110974,1
5483,10966,-5483,1,0.6213576047999431,1
5485,10970,-5485,1,0.6566046886821221,1
5487,10974,-5487,1,0.5762172932499338,1
5488,10976,-5488,1,0.015472324301226248,1
5489,10978,-5489,1,0.27528601309536804,1
5490,10980,-5490,1,0.15371270031362783,1
5492,10984,-5492,1,0.09611448801237366,1
5493,10986,-5493,1,0.6680375012934692,1
5494,10988,-5494,1,0.7513618323383779,1
5495,10990,-5495,1,0.30514916054292573,1
5496,10992,-5496,1,0.28727588905319534,1
5497,10994,-5497,1,0.7510657819920202,1
5499,10998,-5499,1,0.8294718960339335,1
5500,11000,-5500,1,0.9505288193384965,1
5501,11002,-5501,1,0.12155182387303265,1
5503,11006,-5503,1,0.15713632783772646,1
5506,11012,-5506,1,0.3348318691809281,1
5507,11014,-5507,1,0.3818582744294352,1
5508,11016,-5508,1,0.8373695693581574,1
5509,11018,-5509,1,0.21297916452753207,1
5510,11020,-5510,1,0.1562352657188225,1
5512,11024,-5512,1,0.40772923152186513,1
5513,11026,-5513,1,0.18814760006489728,1
5517,11034,-5517,1,0.547573317127283,1
5518,11036,-5518,1,0.9906322216480073,1
5520,11040,-5520,1,0.08817015580334264,1
5521,11042,-5521,1,0.5153599646916154,1
5522,11044,-5522,1,0.5470426768747486,1
5523,11046,-5523,1,0.8752219502741453,1
5524,11048,-5524,1,0.006695475200889978,1
5526,11052,-5526,1,0.1906606800284416,1
5527,11054,-5527,1,0.16950291603086287,1
5528,11056,-5528,1,0.3052600880784514,1
5529,11058,-5529,1,0.8314529255335624,1
5531,11062,-5531,1,0.33302935807615075,1
5532,11064,-5532,1,0.5108556120270514,1
5533,11066,-5533,1,0.6222026160826464,1
5534,11068,-5534,1,0.49919850009528,1
5535,11070,-5535,1,0.25933852773815647,1
5536,11072,-5536,1,0.3989346743588469,1
5537,11074,-5537,1,0.6369763099955947,1
5538,11076,-5538,1,0.13784409847719037,1
5540,11080,-5540,1,0.9870681320960516,1
5541,11082,-5541,1,0.35707656776816443,1
5543,11086,-5543,1,0.729577136070071,1
5544,11088,-5544,1,0.7806860302736583,1
5545,11090,-5545,1,0.3998281640336607,1
5546,11092,-5546,1,0.45618515253021985,1
5547,11094,-5547,1,0.8270630567962647,1
5548,11096,-5548,1,0.9201015754178639,1
5552,11104,-5552,1,0.1878588327862608,1
5553,11106,-5553,1,0.39500919689653613,1
5556,11112,-5556,1,0.73726722656643,1
5558,11116,-5558,1,0.7609296319837668,1
5559,11118,-5559,1,0.9984616348233634,1
5561,11122,-5561,1,0.3268691206235582,1
5562,11124,-5562,1,0.8453440178167624,1
5563,11126,-5563,1,0.8497723576040066,1
5565,11130,-5565,1,0.9226120193110273,1
5566,11132,-5566,1,0.32567205956212664,1
5567,11134,-5567,1,0.9531463797637556,1
5568,11136,-5568,1,0.05465123100407365,1
5569,11138,-5569,1,0.941751130453099,1
5570,11140,-5570,1,0.3815989016816199,1
5571,11142,-5571,1,0.2256380894134955,1
5572,11144,-5572,1,0.3875878155145174,1
5574,11148,-5574,1,0.14482108764201307,1
5578,11156,-5578,1,0.8068215475560002,1
5583,11166,-5583,1,0.5786753679033582,1
5584,11168,-5584,1,0.4673031847758027,1
5585,11170,-5585,1,0.3477975390605841,1
5586,11172,-5586,1,0.4559788837458403,1
5588,11176,-5588,1,0.6025907555926382,1
5590,11180,-5590,1,0.4608933206902941,1
5593,11186,-5593,1,0.8147747476772701,1
5594,11188,-5594,1,0.7794054750960834,1
5596,11192,-5596,1,0.7807482950843541,1
5597,11194,-5597,1,0.6196986661613602,1
5598,11196,-5598,1,0.8555636967990087,1
5600,11200,-5600,1,0.8920648911376037,1
5601,11202,-5601,1,0.13316610600366885,1
5602,11204,-5602,1,0.5834722381424079,1
5603,11206,-5603,1,0.743928526381707,1
5604,11208,-5604,1,0.574509074963988,1
5605,11210,-5605,1,0.4447661855645164,1
5606,11212,-5606,1,0.1676424722865687,1
5610,11220,-5610,1,0.6811586001285393,1
5612,11224,-5612,1,0.602217608538523,1
5613,11226,-5613,1,0.8013095513631432,1
5614,11228,-5614,1,0.5744391444387387,1
5615,11230,-5615,1,0.5484144024859043,1
5616,11232,-5616,1,0.6441553634269193,1
5617,11234,-5617,1,0.636484831331075,1
5618,11236,-5618,1,0.15654185965545342,1
5622,11244,-5622,1,0.8652440723579162,1
5624,11248,-5624,1,0.3204248540196436,1
5626,11252,-5626,1,0.6333377068025686,1
5627,11254,-5627,1,0.20179741167992526,1
5628,11256,-5628,1,0.8927472116481424,1
5632,11264,-5632,1,0.37365697424706446,1
5637,11274,-5637,1,0.6279572858249466,1
5638,11276,-5638,1,0.6001952820968665,1
5639,11278,-5639,1,0.01624578542066779,1
5640,11280,-5640,1,0.17245523461639634,1
5641,11282,-5641,1,0.586799579626955,1
5642,11284,-5642,1,0.5622886517039832,1
5643,11286,-5643,1,0.6833295661878598,1
5644,11288,-5644,1,0.6069297040037608,1
5645,11290,-5645,1,0.12270672349281952,1
5646,11292,-5646,1,0.0056607907730498175,1
5647,11294,-5647,1,0.6414024267133581,1
5648,11296,-5648,1,0.2378283875405004,1
5649,11298,-5649,1,0.6550828223757901,1
5651,11302,-5651,1,0.5172757788923208,1
5652,11304,-5652,1,0.48217193941021386,1
5654,11308,-5654,1,0.7431466132315203,1
5655,11310,-5655,1,0.7037449754967559,1
5660,11320,-5660,1,0.041275815004437555,1
5661,11322,-5661,1,0.33266459741355303,1
5663,11326,-5663,1,0.8226491817405485,1
5664,11328,-5664,1,0.5135183198164711,1
5665,11330,-5665,1,0.4584307842489259,1
5666,11332,-5666,1,0.012971938784301695,1
5667,11334,-5667,1,0.1266634439549158,1
5668,11336,-5668,1,0.626261383425624,1
5669,11338,-5669,1,0.7492613146057793,1
5670,11340,-5670,1,0.8018271295757792,1
5672,11344,-5672,1,0.6940289072664086,1
5673,11346,-5673,1,0.24572589673407763,1
5674,11348,-5674,1,0.6168513461744651,1
5675,11350,-5675,1,0.5121732366226758,1
5676,11352,-5676,1,0.027688392317774424,1
5677,11354,-5677,1,0.6122613322011914,1
5678,11356,-5678,1,0.14597934547471514,1
5679,11358,-5679,1,0.45467522543853744,1
5680,11360,-5680,1,0.8430240460672521,1
5681,11362,-5681,1,0.5742854814571962,1
5682,11364,-5682,1,0.6481972309916487,1
5683,11366,-5683,1,0.5029672979633086,1
5684,11368,-5684,1,0.8278134767760712,1
5685,11370,-5685,1,0.5063207569058404,1
5686,11372,-5686,1,0.8284825588858225,1
5687,11374,-5687,1,0.6769829352750188,1
5688,11376,-5688,1,0.6702201680784335,1
5690,11380,-5690,1,0.9254702885303348,1
5691,11382,-5691,1,0.6660502405829285,1
5692,11384,-5692,1,0.5412541063104135,1
5693,11386,-5693,1,0.12266356386559085,1
5697,11394,-5697,1,0.02097647439301631,1
5698,11396,-5698,1,0.7282078315334499,1
5699,11398,-5699,1,0.7231247378898518,1
5701,11402,-5701,1,0.3050609732166608,1
5703,11406,-5703,1,0.5843910627529361,1
5704,11408,-5704,1,0.3180539638414759,1
5705,11410,-5705,1,0.2786871690965297,1
5706,11412,-5706,1,0.024029351041308433,1
5708,11416,-5708,1,0.27752042056336024,1
5709,11418,-5709,1,0.2690845618488297,1
5710,11420,-5710,1,0.0062441713273670985,1
5711,11422,-5711,1,0.2275255848598906,1
5714,11428,-5714,1,0.20671420852118716,1
5716,11432,-5716,1,0.35645608646548776,1
5717,11434,-5717,1,0.3373941877965878,1
5719,11438,-5719,1,0.5883366923060815,1
5721,11442,-5721,1,0.20548623949066347,1
5722,11444,-5722,1,0.5854798632035271,1
5723,11446,-5723,1,0.360053253907346,1
5724,11448,-5724,1,0.08508244794066833,1
5725,11450,-5725,1,0.645140467992751,1
5727,11454,-5727,1,0.34708764076708876,1
5730,11460,-5730,1,0.485600913831136,1
5734,11468,-5734,1,0.7379796244303356,1
5737,11474,-5737,1,0.5218373909581345,1
5738,11476,-5738,1,0.788571302774169,1
5739,11478,-5739,1,0.5155117285875983,1
5740,11480,-5740,1,0.1448879569546626,1
5741,11482,-5741,1,0.5465340355380738,1
5742,11484,-5742,1,0.025242259947976242,1
5743,11486,-5743,1,0.6126340834329905,1
5745,11490,-5745,1,0.7939088327163625,1
5747,11494,-5747,1,0.6920190941213491,1
5748,11496,-5748,1,0.9250368278045484,1
5751,11502,-5751,1,0.40161855256740064,1
5752,11504,-5752,1,0.7584197108039009,1
5753,11506,-5753,1,0.7864506488137926,1
5754,11508,-5754,1,0.6600040028172931,1
5757,11514,-5757,1,0.06424942276080481,1
5758,11516,-5758,1,0.10729345497498399,1
5759,11518,-5759,1,0.7973335817403262,1
5763,11526,-5763,1,0.891179749609999,1
5764,11528,-5764,1,0.14960341490298312,1
5765,11530,-5765,1,0.6059228886254665,1
5766,11532,-5766,1,0.5619106912710733,1
5767,11534,-5767,1,0.2137615490219863,1
5770,11540,-5770,1,0.49496334190919833,1
5771,11542,-5771,1,0.4697955081808518,1
5772,11544,-5772,1,0.8926750725825637,1
5773,11546,-5773,1,0.20123733860475324,1
5774,11548,-5774,1,0.3595640658100776,1
5775,11550,-5775,1,0.6463556996249672,1
5776,11552,-5776,1,0.8623269657212538,1
5779,11558,-5779,1,0.9100754460781119,1
5780,11560,-5780,1,0.3207540283947954,1
5781,11562,-5781,1,0.8890684793150034,1
5782,11564,-5782,1,0.0276315095105526,1
5783,11566,-5783,1,0.6111982134725001,1
5784,11568,-5784,1,0.7540464546862985,1
5786,11572,-5786,1,0.5872226524254501,1
5787,11574,-5787,1,0.06216498529286041,1
5789,11578,-5789,1,0.28083602922768347,1
5792,11584,-5792,1,0.7254462988007103,1
5794,11588,-5794,1,0.45076732581962164,1
5795,11590,-5795,1,0.05210265454601137,1
5796,11592,-5796,1,0.21905727855189372,1
5797,11594,-5797,1,0.49490534086623794,1
5799,11598,-5799,1,0.4170290704017444,1
5800,11600,-5800,1,0.4389515015467427,1
5801,11602,-5801,1,0.1889758480898961,1
5803,11606,-5803,1,0.40088803542977447,1
5804,11608,-5804,1,0.6271575484818485,1
5805,11610,-5805,1,0.9109876024967529,1
5806,11612,-5806,1,0.16502014216007665,1
5807,11614,-5807,1,0.09625027168285694,1
5808,11616,-5808,1,0.9878374600387997,1
5809,11618,-5809,1,0.357401818491873,1
5810,11620,-5810,1,0.009683837182530741,1
5812,11624,-5812,1,0.8300791861325483,1
5813,11626,-5813,1,0.8431037294844025,1
5815,11630,-5815,1,0.7736711234395021,1
5817,11634,-5817,1,0.415712362087734,1
5818,11636,-5818,1,0.25155414768319917,1
5819,11638,-5819,1,0.592477035450354,1
5821,11642,-5821,1,0.18549123486930308,1
5823,11646,-5823,1,0.27648194256765657,1
5824,11648,-5824,1,0.5695129698662157,1
5825,11650,-5825,1,0.8520695880100942,1
5829,11658,-5829,1,0.7239486752365797,1
5830,11660,-5830,1,0.47269275159052815,1
5831,11662,-5831,1,0.39549973824918483,1
5833,11666,-5833,1,0.7472437719851543,1
5834,11668,-5834,1,0.12335939126395024,1
5835,11670,-5835,1,0.7526097476910819,1
5837,11674,-5837,1,0.9131114745580241,1
5841,11682,-5841,1,0.1541101845196019,1
5842,11684,-5842,1,0.3215000282974021,1
5844,11688,-5844,1,0.17438390557718964,1
5845,11690,-5845,1,0.9044779913280135,1
5847,11694,-5847,1,0.623922365896941,1
5849,11698,-5849,1,0.13596890983703147,1
5850,11700,-5850,1,0.40038395529173787,1
5851,11702,-5851,1,0.23992453568191718,1
5852,11704,-5852,1,0.9852957344941388,1
5853,11706,-5853,1,0.22297128768736918,1
5855,11710,-5855,1,0.4209950976724809,1
5856,11712,-5856,1,0.9405221181110566,1
5857,11714,-5857,1,0.8225970453974629,1
5858,11716,-5858,1,0.8685305241594985,1
5859,11718,-5859,1,0.18576005440838506,1
5862,11724,-5862,1,0.728688765331613,1
5863,11726,-5863,1,0.9663669472537731,1
5864,11728,-5864,1,0.42863845654795085,1
5865,11730,-5865,1,0.6509983739867539,1
5866,11732,-5866,1,0.27470436970770584,1
5868,11736,-5868,1,0.5242031459139306,1
5869,11738,-5869,1,0.4276422209683407,1
5871,11742,-5871,1,0.7910471226612228,1
5875,11750,-5875,1,0.32239397700219496,1
5876,11752,-5876,1,0.11488885949478711,1
5878,11756,-5878,1,0.09538976102907315,1
5879,11758,-5879,1,0.7226008868134979,1
5880,11760,-5880,1,0.398390433165262,1
5881,11762,-5881,1,0.9187168133216311,1
5885,11770,-5885,1,0.795084631706623,1
5886,11772,-5886,1,0.06488792754482609,1
5887,11774,-5887,1,0.3504895353647113,1
5889,11778,-5889,1,0.4806856102736232,1
5890,11780,-5890,1,0.7649762415820051,1
5892,11784,-5892,1,0.22802708375334535,1
5894,11788,-5894,1,0.4403936046334287,1
5897,11794,-5897,1,0.42530328302630815,1
5898,11796,-5898,1,0.9269603604392307,1
5899,11798,-5899,1,0.3772262513113931,1
5901,11802,-5901,1,0.19003978116836773,1
5903,11806,-5903,1,0.08703033169400165,1
5904,11808,-5904,1,0.6232680071851225,1
5905,11810,-5905,1,0.7579999764427838,1
5906,11812,-5906,1,0.9304243186707033,1
5907,11814,-5907,1,0.18251048827452276,1
5908,11816,-5908,1,0.2848758888079914,1
5911,11822,-5911,1,0.5527748973360466,1
5912,11824,-5912,1,0.06341008067941767,1
5913,11826,-5913,1,0.7805592647275632,1
5914,11828,-5914,1,0.5618904180967579,1
5916,11832,-5916,1,0.09105707314432221,1
5917,11834,-5917,1,0.6145544205515354,1
5919,11838,-5919,1,0.020817936080043342,1
5920,11840,-5920,1,0.6806216283314005,1
5922,11844,-5922,1,0.266785651744338,1
5923,11846,-5923,1,0.0510046394129865,1
5924,11848,-5924,1,0.3414206999492855,1
5925,11850,-5925,1,0.38198730071945486,1
5926,11852,-5926,1,0.7152256661774683,1
5928,11856,-5928,1,0.19720308121448138,1
5929,11858,-5929,1,0.6953384114749396,1
5932,11864,-5932,1,0.12370164880164236,1
5933,11866,-5933,1,0.5820363068772035,1
5935,11870,-5935,1,0.6578949119444937,1
5936,11872,-5936,1,0.6082626354651682,1
5937,11874,-5937,1,0.07165559601039839,1
5940,11880,-5940,1,0.9856387957272377,1
5941,11882,-5941,1,0.00045264064250072344,1
5942,11884,-5942,1,0.9522388224704238,1
5943,11886,-5943,1,0.24751284941006724,1
5946,11892,-5946,1,0.8051927750020049,1
5947,11894,-5947,1,0.12159128030925659,1
5949,11898,-5949,1,0.035519800917551025,1
5950,11900,-5950,1,0.7987387224898399,1
5951,11902,-5951,1,0.23595387616280405,1
5952,11904,-5952,1,0.2399704579376557,1
5953,11906,-5953,1,0.1749775747576361,1
5954,11908,-5954,1,0.25004947256767973,1
5955,11910,-5955,1,0.30311975634004884,1
5956,11912,-5956,1,0.001582427643656903,1
5957,11914,-5957,1,0.70722164292669,1
5962,11924,-5962,1,0.6299504990741852,1
5963,11926,-5963,1,0.09045090872660932,1
5964,11928,-5964,1,0.12343587799189948,1
5965,11930,-5965,1,0.03133582753034636,1
5966,11932,-5966,1,0.8187430246321149,1
5967,11934,-5967,1,0.324053779798808,1
5969,11938,-5969,1,0.969098861181141,1
5970,11940,-5970,1,0.5528776390233724,1
5971,11942,-5971,1,0.7627443830478746,1
5972,11944,-5972,1,0.9076114116275105,1
5973,11946,-5973,1,0.25167512878403586,1
5976,11952,-5976,1,0.8134798926246707,1
5977,11954,-5977,1,0.6370214172255063,1
5978,11956,-5978,1,0.9292630414771407,1
5979,11958,-5979,1,0.5925085351388589,1
5980,11960,-5980,1,0.4625555286380809,1
5981,11962,-5981,1,0.6910037978839435,1
5982,11964,-5982,1,0.5283317774915307,1
5983,11966,-5983,1,0.3106059084133974,1
5984,11968,-5984,1,0.8519536434367413,1
5985,11970,-5985,1,0.41071869811206607,1
5986,11972,-5986,1,0.21447252175446097,1
5987,11974,-5987,1,0.3457534154670774,1
5988,11976,-5988,1,0.99154971856996,1
5989,11978,-5989,1,0.769201236230874,1
5990,11980,-5990,1,0.3645890238292756,1
5991,11982,-5991,1,0.8179334224502276,1
5992,11984,-5992,1,0.4897555428322855,1
5993,11986,-5993,1,0.8413644019743084,1
5995,11990,-5995,1,0.3053513655413935,1
5996,11992,-5996,1,0.11023865948256228,1
5997,11994,-5997,1,0.005878594330411602,1
